COM
COMANY
CO
COMAPANY
COMAPNY
CMPAN
CMPANIE
CMPANY
COMPANYINC
COMPANYLLC
COMPAMY
CMPNIE
CMPNY
COMPAGNIE
COMPAN
COMPANIA
COMPANIE
COMPNAY
COMPNY
KOMPANY
CORP
COPORATE
COPORATION
CORPERATION
CORPO
CORPOR
CORPORA
CORPORACION
CORPORAITON
CORPORAT
CORPORATE
CORPORATED
CORPORATI
CORPORATIO
CORPORATION
CORPORATON
CORPORTATION
CORPORTION
CORPRATION
CORPROATION
COPR
COPRORATION
CORORATION
COMPANY
INCCORPORATE
INCCO
INCCOM
INCCORP
INCCPA
INCD
INC
INCOPORATED
INCOR
INCORP
INCORPERATED
INCORPO
INCORPOR
INCORPORA
INCORPORADO
INCORPORAT
INCORPORATE
INCORPORATING
INCORPORATION
INCORPORTATED
INCORPORTED
INCORPRATED
INCORPROATED
INCRPORATION
INCRPRATION
LP
LLC
LLP
LLLP
PLLC
OF
THE
AND
LTD
ON
0|ZERO
1|ONE|FIRST|1ST|FRST|ONCE|SINGLE|SINGLY|SINGULAR|SINGLEY|SINGULARITY|SNG|SNGLE|UN|UNO
2|2ND|SECOND|TWO|TWICE|TWOWAY|SECONDARY|SECONDHAND|DEUX|DOS
3|3RD|THIRD|THREE|THRICE|TERTIARY|THREEFOLD|TRIO|TRIPPLE|TRIPLE|TROIS|TRES|THREESOME|TRIPLET|TRIPI|TRIPLETT|TRIPLEX
4|4TH|FOURTH|FOUR|FOURPLEX|FOURSOME|FOURSQUARE|FOURSTAR|FOURWAY|QUARTET|QUATRO|QUATTRO|QUADRUPLE|QUAD|QUADE|QUADRA|QUADRANGLE|QUADRANT|QUADRI|QUADRO|QUATRE|CUATRO
5|5TH|FIFTH|FIVE|QUINTET|CINC|CINCO|QUINTUPLE
6|6TH|SIXTH|SIX|SEXTET|SEI
7|7TH|SEVENTH|SEVEN|SEPT|SIETE
8|8TH|EIGHTH|EIGHT|HUIT|OCHO|OCTO
9|9TH|NINTH|NINE|NEUF|NUEVE|NINER
10|10TH|TENTH|TEN|DIX|DIEZ
11|11TH|ELVENTH|ELEVEN
12|12TH|TWELFTH|TWELVE
13|13TH|THIRTEENTH|THIRTEEN
14|14TH|FOURTEEN|FOURTEENTH
15|15TH|FIFTEEN|FIFTEENTH
16|16TH|SIXTEEN|SIXTEENTH
17|17TH|SEVENTEEN|SEVENTEENTH
18|18TH|EIGHTEEN|EIGHTEENTH
19|19TH|NINETEEN|NINETEENTH
20|20TH|TWENTY|TWENTIETH
21|21ST|TWENTYFIRST|TWENTYONE
22|22ND|TWENTYSECOND|TWENTYTWO
23|23RD|TWENTYTHIRD|TWENTYTHREE
24|24TH|TWENTYFOURTH|TWENTYFOUR
25|25TH|TWENTYFIFTH|TWENTYFIVE
26|26TH|TWENTYSIXTH|TWENTYSIX
27|27TH|TWENTYSEVENTH|TWENTYSEVEN
28|28TH|TWENTYEIGHTH|TWENTYEIGHT
29|29TH|TWENTYNINTH|TWENTYNINE
30|30TH|THIRTY|THIRTIETH
31|31ST|THIRTYFIRST|THIRTYONE
32|32ND|THIRTYSECOND|THIRTYTWO
33|33RD|THIRTYTHIRD|THIRTYTHREE
34|34TH|THIRTYFOURTH|THIRTYFOUR
35|35TH|THIRTYFIFTH|THIRTYFIVE
36|36TH|THIRTYSIXTH|THIRTYSIX
37|37TH|THIRTYSEVENTH|THIRTYSEVEN
38|38TH|THIRTYEIGHTH|THIRTYEIGHT
39|39TH|THIRTYNINTH|THIRTYNINE
40|40TH|FORTY|FORTIETH
41|41ST|FORTYFIRST|FORTYONE
42|42ND|FORTYSECOND|FORTYTWO
43|43RD|FORTYFOURD|FORTYTHREE
44|44TH|FORTYFOURTH|FORTYFOUR
45|45TH|FORTYFIFTH|FORTYFIVE
46|46TH|FORTYSIXTH|FORTYSIX
47|47TH|FORTYSEVENTH|FORTYSEVEN
48|48TH|FORTYEIGHTH|FORTYEIGHT
49|49TH|FORTYNINTH|FORTYNINE
50|50TH|FIFTY|FIFTIETH
51|51ST|FIFTYFIRST|FIFTYONE
52|52ND|FIFTYSECOND|FIFTYTWO
53|53RD|FIFTYFOURD|FIFTYTHREE
54|54TH|FIFTYFOURTH|FIFTYFOUR
55|55TH|FIFTYFIFTH|FIFTYFIVE
56|56TH|FIFTYSIXTH|FIFTYSIX
57|57TH|FIFTYSEVENTH|FIFTYSEVEN
58|58TH|FIFTYEIGHTH|FIFTYEIGHT
59|59TH|FIFTYNINTH|FIFTYNINE
60|60TH|SIXTY|SIXTIETH
61|61ST|SIXTYFIRST|SIXTYONE
62|62ND|SIXTYSECOND|SIXTYTWO
63|63RD|SIXTYFOURD|SIXTYTHREE
64|64TH|SIXTYFOURTH|SIXTYFOUR
65|65TH|SIXTYFIFTH|SIXTYFIVE
66|66TH|SIXTYSIXTH|SIXTYSIX
67|67TH|SIXTYSEVENTH|SIXTYSEVEN
68|68TH|SIXTYEIGHTH|SIXTYEIGHT
69|69TH|SIXTYNINTH|SIXTYNINE
70|70TH|SEVENTY|SEVENTIETH
71|71ST|SEVENTYFIRST|SEVENTYONE
72|72ND|SEVENTYSECOND|SEVENTYTWO
73|73RD|SEVENTYFOURD|SEVENTYTHREE
74|74TH|SEVENTYFOURTH|SEVENTYFOUR
75|75TH|SEVENTYFIFTH|SEVENTYFIVE
76|76TH|SEVENTYSIXTH|SEVENTYSIX
77|77TH|SEVENTYSEVENTH|SEVENTYSEVEN
78|78TH|SEVENTYEIGHTH|SEVENTYEIGHT
79|79TH|SEVENTYNINTH|SEVENTYNINE
80|80TH|EIGHTY|EIGHTIETH
81|81ST|EIGHTYFIRST|EIGHTYONE
82|82ND|EIGHTYSECOND|EIGHTYTWO
83|83RD|EIGHTYFOURD|EIGHTYTHREE
84|84TH|EIGHTYFOURTH|EIGHTYFOUR
85|85TH|EIGHTYFIFTH|EIGHTYFIVE
86|86TH|EIGHTYSIXTH|EIGHTYSIX
87|87TH|EIGHTYSEVENTH|EIGHTYSEVEN
88|88TH|EIGHTYEIGHTH|EIGHTYEIGHT
89|89TH|EIGHTYNINTH|EIGHTYNINE
90|90TH|NINETY|NINETIETH
91|91ST|NINETYFIRST|NINETYONE
92|92ND|NINETYSECOND|NINETYTWO
93|93RD|NINETYFOURD|NINETYTHREE
94|94TH|NINETYFOURTH|NINETYFOUR
95|95TH|NINETYFIFTH|NINETYFIVE
96|96TH|NINETYSIXTH|NINETYSIX
97|97TH|NINETYSEVENTH|NINETYSEVEN
98|98TH|NINETYEIGHTH|NINETYEIGHT
99|99TH|NINETYNINTH|NINETYNINE
100|100TH|HUNDRED|HUNDREDTH|ONEHUNDRED|ONEHUNDREDTH|HNDRD
ABOUND|ABOUNDING
ABSOLUTE|ABSOLTELY|ABSOLUT|ABSOLUTELY
ABSTRACT|ABSTRACTING|ABSTRACTION|ABSTRACTOR
ABUNDANT|ABUNDANCE|ABUNDANTE|ABUNDANTLY
ABUSE|ABUSED
ACADEMY|ACADAMY|ACAD|ACADE|ACADEM|ACADEMIA|ACADEMIC|ACADEMIE|ACADMY|ACDEMIC|ACDEMY|ACDM|ACDMIC|ACDMY
ACADIA|ACADIAN|ACADIANA
ACCELERATE|ACCEL|ACCELERATED|ACCELERATION|ACCELERATOR|ACCELRTED|XLR8
ACCEPT|ACCEPTANCE|ACCEPTED|ACCPTED|ACCPTNCE
ACCESSIBLE|ACCESSIBILIT|ACCES
ACCESSORY|ACCESORIE|ACCESORIO|ACCESSO|ACCESSOR|ACCESSORI|ACCESSORIE|ACCESSORIZE|ACESSORIE|ASSESSORIE
ACCIDENT|ACCDENT|ACCIDENTAL
ACCLAIM|ACCLAIMED
ACCOUNT|ACCOUNTANT|ACCOUNTING|ACCOUNTANCY|ACCNTANT|ACCNT|ACCNTANCY|ACCNTING|ACCNTNCY|ACCNTNG|ACCNTNT|ACCOU|ACCOUN|ACCOUNTI|ACCOUNTIN|ACCOUNTNG|ACCOUTING|ACCT|ACCTG|ACCTING|ACCTNG|ACCTNT|ACCUNT|ACCUNTANCY|ACCUNTANT|ACCUNTING|ACOUNTING
ACCOMMODATION|ACCOMMODATOR|ACCOMODATION
ACCORD|ACCORDING
ACCOUNTABLE|ACCOUNTABILITY
ACOUSTIC|ACCOUSTIC|ACCOUSTICAL|ACOUSTICAL
ACCREDITED|ACCREDITATION|ACCREDITING
ACUPUNCTURE|ACCUPUNCTURE|ACCUPRESSURE|ACPNCTR|ACPNCTURE|ACPUNCTURE|ACUPRESSURE|ACUPUNCTURIST|ACUPUNTURE
ACCURATE|ACCURACY|ACCURITE
ACHIEVE|ACHIEVEMENT|ACHIEVER|ACHIEVING|ACHVEMENT|ACHVMENT
ACQUISITION|ACQ|ACQISITION|ACQSITION|ACQSTION|ACQSTON|ACQUA|ACQUEST|ACQUI|ACQUIRE|ACQUIRED|ACQUIRING|ACQUISITON|ACQUISTION|ACQUSITION
ACRE|ACREAGE
ACROBAT|ACROBATIC
ACTION|ACCION
ACTIVATE|ACTIVATED|ACTIVATION|ACTIVE|ACTIVELY
ACTIVITY|ACTIVITIE|ACTVTIE
ACTUAL|ACTUARIAL|ACTUARIE
ADAPT|ADAPTABLE|ADAPTATION|ADAPTED|ADAPTIVE
ADDICT|ADDCTION|ADDCTN|ADDICTED|ADDICTION|ADDICTIVE
ADJUST|ADJUSTABLE|ADJUSTER|ADJSTER|ADJUSTING|ADJUSTMENT|ADJUSTOR
ADMIN|ADMINISTRATION|ADMINISTRATIVE|ADMINSTRATION|ADM|ADMI|ADMINI|ADMINISTRATOR|ADMINSTRATIVE|ADMINSTRATOR|ADMINSTRTIVE|ADMN|ADMNISTRATOR|ADMNSTRATOR|ADMNSTRTOR
ADOLESCENT|ADLSCENT
ADOPT|ADOPTION|ADOPTIVE|ADPTION
ADORE|ADORABLE|ADORACION|ADORATION
ADORN|ADORNED|ADORNMENT|ADORNO
ADRENALIN|ADRENALINE
ADULT|ADLT
ADVANCE|ADVA|ADVAN|ADVANC|ADVANCD|ADVANCED|ADVANCEMENT|ADVANCING|ADVNCD|ADVNCE|ADVNCED|ADVNCEMENT|ADVNCMENT|ADVNCMNT
ADVANTAGE|ADVANT|ADVNT|ADVNTAGE|ADVG
ADVENTURE|ADVEN|ADVENT|ADVENTU|ADVENTUR|ADVENTURER|ADVENTUROU|ADVNTR|ADVNTRE|ADVNTURE|EDVENTURE
ADVERTISE|ADVERT|ADVERTISEMENT|ADVERTISER|ADVERTISI|ADVERTISIN|ADVERTISING|ADVERTIZING|ADVERTSING|ADVRTSNG
ADVICE|ADVISE|ADVISEMENT|ADVISER|ADVISING|ADVISO|ADVISOR|ADVISORY|ADVSOR|ADVSORY|ADVSR|ADVSRY
ADVOCATE|ADVOCATING|ADVO|ADVOC|ADVOCACY|ADVCACY|ADVCATE|ADVCTE|ADVOCTE
AERONAUTIC|AERONAUTICAL
AFFAIR|AFFAIRE
AFFECT|AFFECTION|AFFECTIVE
AFFILIATE|AFFIL|AFFILATED|AFFILIATED|AFFILIATION|AFFILTED
AFFIRM|AFFIR|AFFIRMATION|AFFIRMATIVE|AFFIRMED
AFFLUENT|AFFLUENCE
AFFORD|AFFORABLE|AFFORDABLE|AFFORDBLE|AFFORTABLE|AFFR|AFFRDBL|AFFRDBLE|AFORDABLE
AFRICAN|AFRCAN|AFRCN|AFRI|AFRICA|AFRICANA|AFRICANAMERICAN|AFRICIAN|AFRIK|AFRIKA|AFRIKAN|AFRIQUE
AGENT|AGEN|AGENC|AGENCIA|AGENCIE|AGENCYINC|AGENY|AGNC|AGNCY|AGNT|AGENCY|AGCY
AGGREGATE|AGGREGATOR
AGILE|AGILITY
AGAINST|AGINST|AGNST
AGRICULTURE|AGRIBUSINES|AGRICULTURAL|AGRCLTURE|AGRISERVICE|AGRI|AGRITECH|AGRO|AGRONOMY
AID|AIDED|AIDING
AIRBRUSH|AIRBRUSHING
AIRCONDITION|AIRCONDITIONER|AIRCONDITIONED|AIRCO|AIRCON|AIRCONDITIONING|ARCONDITIONING
AIR|AIRPLANE|AEROPLANE|AIRSHIP|BIPLANE|BLIMP|ZEPPELIN|SEAPLANE|AIRCRAFT|AIRCRFT|HELICOPTER|AVIATION|AVAITION|AVIATOR|AIRPORT|AIRSTRIP|AIRPRT|HELIPORT|AIRMAN|AIRMEN|AIRLINE|AIRLES
AK|ALASKA|ALASKAN|ALSKA
AL|ALABAMA|BAMA|ALBMA|ALABAMAN
ALADDIN|ALADIN
ALCHEMIST|ALCHEMY
ALCOHOL|ALCHL|ALCHOL|ALCOHOLIC|ALCOHOLISM
ALIGN|ALIGNED|ALIGNMENT
ALKALI|ALKALINE
ALTERATION|ALTER|ALTERA|ALTERED|ALTRTION
ALTERNATE|ALTERNA|ALTERNATION|ALTERNATIVE|ALTERNTIVE|ALTERNTV|ALTERNTVE|ALTRNATIVE|ALTRNTIVE|ALTRNTV|ALTRNTVE
AMALGAM|AMALGAMATED
AMAZE|AMAZIN|AMAZING|AMAZINGLY
AMBASSADOR|AMBA|AMBASSDOR|AMBE
AMBIANCE|AMBIENCE|AMBIENT|AMBIENTE
AMBULANCE|AMBLANCE|AMBLNCE
AMBULATORY|AMBLTORY
AMERICA|AMERICAN|AMERICANA|AMERCIAN|AMERCA|AMERCAN|AMERI|AMERIC|AMERICANO|AMERICN|AMRICA|AMRICAN|AMRCA|AMRCAN|AMRCN|MERICA|MERICAN|PANAMERICAN|AMERCN|AMER
AMMUNITION|AMMO|MUNITION|GUNPOWDER
AMPLIFY|AMPLIFICATION|AMPLIFIED|AMPLIFIER
AMUSE|AMUSEMENT|AMUSMENT
ANALYSI|ANALYST|ANALYTIC|ANALYTICA|ANALYTICAL|ANALYZER|ANLYST|ANLYTCAL|ANLYTIC
ANCESTOR|ANCESTRAL|ANCESTRY
ANCHOR|ANCHORAGE|ANCHORED
ANESTHESIA|ANESTHESIOLOGIST|ANESTHESIOLOGY|ANESTHETIC|ANESTHETIST|ANESTHSIA|ANETHESIA|ANSTHESIA|ANSTHSIA|SEDATION
ANIMATED|ANIMATION|ANIME
ANOINTED|ANOINTING|ANOITED
ANSWER|ANSWERED|ANSWERING|ANSWRING
APT|APARTMENT|APARMENT|APARTM|APARTME|APARTMEN|APARTMNT|APPARTMENT|APRTMENT|APRTMNT
APPALACHIA|APPALACHIAN|APPALCHIAN
APPAREL|APPARELL|APPARREL
APPEAL|APPEALING
APPEAR|APPEARANCE|APPEARING
APPETITE|APPETIT|APPETIZER
APPLICATION|APPLCATION|APPLCTION|APPLCTON|APPLICANT|APPLICATOR
APPLIANCE|APPLIA|APPLIAN|APPLIANC|APPLICANCE|APPLNC|APPLNCE
APPLY|APPLIED|APPLING
APPOINTED|APPOINTMENT|APPT
APPRAISAL|APPRAI|APPRAISA|APPRAISE|APPRAISEL|APPRAISER|APPRAISING|APPRASAL|APPRASIAL|APRAISAL|APPRISAL|APPRISER|APPRSAL|APPRSER|APPRSL|APPRSR
APPRENTICE|APPRENTICESHIP
APPROACH|APPROACHE
APPROVAL|APPROVED
APOSTOLIC|APISTOLIC|APSTLC|APSTLIC|APSTOLIC|APOSTLE
AR|ARKANSAS|ARKANSAN
ARAB|ARABIA|ARABESQUE|ARABIAN|ARABIC
ARBITER|ARBITRAGE|ARBITRATION|ARBITRATOR
ARBOR|ARBORETUM|ARBORICULTURE|ARBORIST
ARCHEOLOGY|ARCHAEOLOGIST|ARCHAEOLOGY|ARCHAEOLOGICAL|ARCHEOLOGICAL
ARCHER|ARCHERY
ARCHITECT|ARCHIT|ARCHITCTRAL|ARCHITCTURAL|ARCHITEC|ARCHITECH|ARCHITECHT|ARCHITECTUAL|ARCHITECTUR|ARCHITECTURAL|ARCHITECTURE|ARCHT|ARCHTCT|ARCHTCTRAL|ARCHTCTRL|ARCHTCTURAL|ARCHTECT|ARCHTECTURAL|ARCTURU
ARCHIVE|ARCHIVAL|ARCHIVING
ARMOR|ARMORED|ARMORY
ARRANGE|ARRANGED|ARRANGEMENT|ARRANGER
ARTISAN|ARTISANAL|ARTISIAN|ARTIZAN
ARTIST|ARTISTA|ARTISTE|ARTISTIC|ARTISTICALLY|ARTISTRY|ARTST|ARTSTIC|ARTSTRY|ARTSY
ASCEND|ASCENCION|ASCENCIO|ASCENDANT|ASCENDING|ASCENSION|ASCENT
ASIA|ASIAN|ASIANA|ASIANAMERICAN
ASPHALT|ASPHAULT
ASPIRE|ASPIRATION|ASPIRING
ASSEMBLY|ASSEMBLIE|ASSEM|ASSEMB|ASSEMBL|ASSEMBLAGE|ASSEMBLE|ASSEMBLED|ASSEMBLEIA|ASSEMBLER|ASSEMBLEY|ASSEMBLING|ASSMBLY|ASSEMBLYMAN
ASSESSOR|ASSES|ASSESMENT|ASSESSING|ASSESSMENT|ASSESSMNT|ASSSSMENT
ASSET|ASSEST|ASSETT
ASSIGN|ASSIGNEE|ASSIGNMENT
ASSIST|ASSISI|ASSI|ASSISTA|ASSISTAN|ASSISTANC|ASSISTANCE|ASSISTANT|ASSISTD|ASSISTED|ASSISTING|ASSISTIVE|ASSISTNC|ASSISTNCE|ASSISTNT|ASSITANCE|ASSITED|ASSSTANCE|ASSSTANT|ASSSTED|ASSSTNCE|ASST|ASSTD|ASSTNCE
ASSOCIATE|ASSOCIATION|ASSOCAITE|ASSCOIATE|ASSCOCIATE|ASSCIATE|ASSOCATE|ASOCIATE|ASSOICATE|ASSOSIATE|ASSSOCIATE|ASSOCATION|ASSC|ASSCATI|ASSCATIO|ASSCATION|ASSCIA|ASSCIAT|ASSCIATI|ASSCIATIO|ASSCIATION|ASSCN|ASSCO|ASSCT|ASSCTE|ASSCTIO|ASSCTION|ASSCTN|ASSCTON|ASSOC|ASSOCAITION|ASSOCATED|ASO|ASOCIATION|ASOCICION|ASOC|ASOCIACION|ASOCIADO|ASSOCI|ASSOCIA|ASSOCIAITON|ASSOCIAT|ACCOCIATE|ASSOCIATESINC|ASSOCIATESLLC|ASSOCIATI|ASSOCIATIE|ASSOCIATIO|ASSOCIATIONINC|ASSOCIATN|ASSOCIATON|ASSOCIAZIONE|ASSOCITE|ASSOCN|ASSOCT|ASSOCTE|ASSOCTED|ASSOCTION|ASSOCTN|ASSOD|ASSOICATION|ASSSOCIATION|SUBASSOCIATION|ASSO|ASSN|ASSOCIATED
ASSURE|ASSURANCE|ASSURANT|ASSURED|ASSURITY
ASTROLOGER|ASTROLOGICAL|ASTROLOGY
ASTRONOMY|ASTRON|ASTRONAUT|ASTRONOMICAL
ATHLETIC|ATHELETIC|ATHL|ATHLETE|ATHLETICA|ATHLETIX|ATHLTC|ATHLTIC
ATMOSPHERE|ATMOSPHERIC
ATTACHED|ATTACHMENT|ATTACH|ATACH|ATACHMENT|ATACHED
ATTENTION|ATTENTIVE|ATTN
ATTORNEY|ATTORNY|ATTNY|ATTO|ATTONEY|ATTOR|ATTORN|ATTORNE|ATTORNEYATLAW|ATTRNEY|ATTRNY|ATTY|BARRISTER|LAW|LAWFIRM|LAWMAN|LAWSUIT|LAWYER|LWYER|LWYR|LEGAL|LEGADO|LEG|LEGA|LEGALE|LEGALLY|LGAL
ATTRACT|ATTRACTION|ATTRACTIVE
AUCTION|AUCT|AUCTIONEER|AUCTIONEERING|AUCTN|AUCTNR
AUDIO|AUDIOVIDEO|AUDIOVISUAL
AUDIOLOGICAL|AUDIOLOGIST|AUDIOLOGY|AUDITORY
AUDIT|AUDITING|AUDITOR
AUSTRALIA|AUSTRALIAN
AUSTRIA|AUSTRIAN
AUTHENTIC|ATHNTIC|AUTHENTICATION
AUTHOR|AUTH|AUTHO
AUTHORITY|AUTHORITIE|AUTHORIZED|ATHRZED
AUTISM|AUTISTIC
AUTOMATE|AUTOMATED|AUTOMATIC|AUTMTC|AUTO|AUTOMATION|AUTOMATIVE|AUTOMTED|AUTOMTN|ATMTC|ATMTN
AUXILIARY|AUX|AUXILARY|AUXILLARY|AUXILLIARY
AVAILABLE|AVAIL
AVE|AVENUE
AWARE|AWARENES|AWARNES|AWRENES|AWRNES
AWN|AWNG|AWNING
BABYSITTER|BABYSITTING|BABYSIT
BAG|BAGGAGE|BAGGER|BAGGING
BALANCE|BALANCED|BALANCING|BLNCE
BANK|BANKER|BANKING|BNK|BNKER|BNKG|BNKR
BAPTIST|BAPIST|BAPT|BAPTI|BAPTISH|BAPTST|BPTIST|BAPTISM
BAR|BARTENDER|BARTENDING|TAPHOUSE|TAPROOM|TAVERN|PUB
BASEBALL|BASEBAL
BASIC|BASICALLY
BASKET|BASKETRY|BSKET|BSKT
BASKETBALL|BSKETBALL|BSKTBALL|BSKTBLL
BEAD|BEADED|BEADERY|BEADING|BEADWORK
BEAUTY|BEAUT|BEAUTE|BEAUTFUL|BEAUTI|BEAUTICIAN|BEAUTICONTROL|BEAUTIE|BEAUTIFICATION|BEAUTIFUL|BEAUTIFULLY|BEAUTIFY
BECOME|BECOMING
BEEKEEPER|BEEKEEPING|APIARY
BEEP|BEEPER|BEEPING
BEGIN|BEGINING|BEGINNER|BEGINNING|BGINNING|BGNNING|BGNNNG|BEGAN
BEHAVIOR|BEHAV|BEHAVIORAL|BEHAVIORIAL|BEHAVORIAL|BEHAVRAL|BEHAVRL|BHVIOR|BHVIORAL|BHVORAL|BHVRAL|BHVRL|BEHAVE
BELIEF|BELIEVE|BELIEVER|BELIEVING
BENEFIT|BENEFT|BENEFICIAL|BENEFICIARY|BENIFIT|BNEFIT|BNEFT|BNFIT|BNFT
BENEVOLENCE|BENEVOLENT|BNVLENT|BNVOLENT
BIKE|CYCLE|CYCLERY|CYCLEWORK|CYCLING|CYCLIST|BICYCLE|BICY|BICYC|BICYCE|BICYCEL|BICYCL|BICYCLER|BICYCLIN|BICYCLING|BICYCLIST|BICYCLNG|BICYCLST|BICYCYLE|BICYLE|BICYL|EBIKE|EBIKER|TRICYCLE|TRIKE
BIND|BINDER|BINDERY|BINDING|BOUND
BIRD|AVIAN|AVIARA|AVIARIE|AVIARY|BIRDING|BIRDWATCHING|BIRDWATCHER
BLACK|NEGRA|NEGRI|NEGRO|NIGRO|NERO
BLAST|BLASTER|BLASTG|BLASTING
BLEND|BLENDED|BLENDER|BLENDING
BLESSED|BLESSING|BLEST|BLES
BLISSFUL|BLISSFULLY|BLIS
BLUEPRINT|BLUEPRINTING
BOARDER|BOARDING|BRDER|BRDG|BOARD
BOAT|BOATER|BOATING|TRAWLER|TUGBOAT|MOTORBOAT|BOATBUILDER|BOATBUILDING|BOATMAN|BOATMEN|BOATWORK|BOATRIGHT|BOATWRIGHT|BODYWORK|BDYWORK|BDYWRK
BOHEMIAN|BOHEME|BOHEMIA
BOIL|BOILED|BOILER|BOILING
BOOK|BOOKBINDER|BOOKBINDING
BOOKKEEP|BOOKKEEPER|BOOKKEEPIN|BOOKKEEPING|BKKEEPING|BKKEPING|BKKPING|BKKPNG|BOOKKPNG|BKPG|BOKKEEPING|BOOKEEPING
BOOST|BOOSTE|BOOSTED|BOOSTER|BOOSTR
BOSTON|BOSTONIAN
BOTANY|BOTANA|BOTANIC|BOTANICA|BOTANICAL
BOUTIQUE|BOTIQUE|BOUTIQ|BOUTIQU
BRAID|BRAIDED|BRAIDING
BRAZIL|BRAZILIAN|BRAZILLIAN
BRANCH|BRNCH
BRAND|BRND|BRANDING|BRANDED
BREAKFAST|BREAKF|BREAKFA|BRKFAST|BRKFST
BREAKTHROUGH|BREAKTHRU|BREAKTHRUGH
BREATH|BREATHE|BREATHING
BREED|BREEDER|BREEDING
BRICK|BRICKLAYER|BRICKLAYING
BRIGHT|BRIGHTEN|BRIGHTER|BRIGHTEST|BRIGHTLY
BRILLIANT|BRILLANT|BRILLANTE|BRILLIANCE
BROADCAST|BRDCSTG|BROADCASTER|BROADCASTING
BROADWAY|BRDWAY
BROKE|BROKEN|BROKER|BRKG|BRKR|BROKERAG|BROKERAGE|BROK|BROKAGE|BROKERING|BROKR
BROOKLYN|BKLYN|BRKLYN
BROTHER|BROTHERHOOD|BROTHERLY|BROTHR|BROTHRHOOD|BRTHD|BRTHER|BRTHR|BRTHRHD|BRO
BRUSH|BRUSHED|BRUSHING|BRUSHWORK
BUBBLE|BUBBLING|BUBBLY|BUBBLER
BUDDHA|BUDDHISM|BUDDHIST
BUDGET|BUDGETING
BUICK|BUICKGMC
BUILD|BUIL|BUILDE|BUILDERSINC|BUILDI|BUILDIN|BUILDING|BUILDNG|BUILDR|BUILT|BULDER|BULDING|BULIDING|BUILDER|BLDR
BUSINESS|BUISNES|BUSI|BUSIN|BUSINE|BUSINES|BUSINESSE|BUSINESSMEN|BUSINS|BUSNES|BUSNS|EBIZ|EBUSINES|EBUSINESS
BULLDOZER|BULLDOZING|DOZER
BUMP|BUMPER|BUMPY
BURIAL|BURIED|BURY
BUY|BUYER|BUYING|BUYOUT|BOUGHT
CABINET|CABINETMAKER|CABINETRY|CABINETWORK|CABINTRY
CABLE|CABLING
CAGE|CAGED|CAGER
CALCULATED|CALCULATION|CALCULATOR|CALC|CALCULATE
CALENDAR|CALENDER
CA|CALFORNIA|CALF|CALI|CALIFO|CALIFOR|CALIFORN|CALIFORNI|CALIFORNIA|CALIFORNIAN|CALIFRNIA|CALIF
CALIBER|CALIBRATED|CALIBRATION|CALIBRE
CALVARY|CALVERY
CAMBODIA|CAMBODIAN
CAMBRIA|CAMBRIAN
CAMBRIDGE|CAMBRDGE
CAMPBELL|CMPBELL
CAMPAIGN|CMPIGN
CAMP|CAMPGROUND|CAMPING|CMPGROUND|CMPGRUND|KAMPGROUND|KAMP
CANADA|CANADIAN
CANCEL|CANCELLATION
CANCER|CANCR|CNCER|ONCOLOGY|ONC|ONCLGY|ONCLOGY
CANDLE|CNDLE
CANDY|CNDY
CAPABLE|CAPABILITY|CAPABILITIE
CAPITAL|CAPIT|CAPITA|CAPITALIST|CAPITALIZED|CAPITL|CAPITOL|CAPITOLA|CAPTAL|CAPTL|CPITL|CPTAL|CPTL|CPTOL
CAPTAIN|CAPT
CAPTION|CAPTIONING
CAPTURE|CAPTURED|CAPTURING|CAPTIVATE|CAPTIVA|CAPTIVATING|CAPTIVE
CAREGIVER|CAREGIVING|CARETAKER|CARETAKING
CARGO|CRGO
CAROLINA|CROLINA
CARPENTER|CARPENTERY|CARPENTR|CARPENTRY|CARPTR|CRPENTRY|CRPNTRY
CARPET|CARPETING|CARPT|CRPET|KARPET|RUG
CARIBBEAN|CARRIBBEAN|CRBBEA|CRIBBEAN|CARIBEAN|CARIB|CARIBBIAN|CARIBEN
CARRY|CARRYING|CARRYOUT
CARTOGRAPHER|CARTOGRAPHIC|CARTOGRAPHY
CASH|CASHED|CASHER|CASHIER|CASHING
CASTLE|CSTLE
CATASTROPHE|CATASTROPHIC
CATCH|CATCHER|CATCHING
CATER|CATERED|CATERER|CATERI|CATERIN|CATERING
CATHEDRAL|CATHEDRA|CTHDRAL
CATHOLIC|CTHLC|CTHLIC
CATTLE|CATTLEMAN|CATTLEMEN|CTTLE
CAULK|CAULKING
CELEBRATE|CELEBRATING|CELEBRATION
CELEBRITY|CELEBRITIE|CELEB
CELL|CELLULAR|CELLUAR|CELULAR|CELULARE
CELTIC|CELT
CEMENT|CEMENTING
CEMETERY|CEMETARY|CEMETERIE|CEMETRY|CMTRY|TOMB|TOMBSTONE|GRAVE|GRAVEYARD
CENTURY|CNTURY
CERAMIC|CRMIC
CERTAIN|CERTAINTY
CERTIFIED|CERT|CERTA|CERTFD|CERTI|CERTIF|CERTIFD|CERTIFICATE|CERTIFICATION|CRTFCTION|CRTFD|CRTIF
CHALLENGE|CHALLENGED|CHALLENGER|CHALLENGING|CHLLNGE
CHAMBER|CHAMBR|CHAMB|CHAM|CHMBER|CHMBR
CHAMP|CHAMPION|CHAMPIONSHIP|CHMPN
CHANGE|CHANGED|CHANGER|CHANGING|CHNG|CHNGE|CHNGING
CHAPLAIN|CHAPLAINCY
CHAPTER|CHAPT|CHAPTE|CHAPTR|CHPT|CHPTER|CHPTR
CHARGE|CHARGED|CHARGER|CHARGING
CHARISMA|CHARISMATIC
CHARITY|CHARIT|CHARITA|CHARITAB|CHARITABL|CHARITABLE|CHARITBLE|CHARITIE|CHRITABLE|CHRITIE|CHRITY|CHRT|CHRTABLE|CHRTBL|CHRTBLE|CHRTIE|CHRTY
CHARM|CHARMED|CHARMER|CHARMING
CHART|CHARTE|CHARTER|CHARTERED|CHARTERING|CHARTIER|CHARTING|CHRTER|CHRTR
CHATTANOOGA|CHATTNOGA|CHATTOOGA
CHEAP|CHEAPER|CHEAPEST|CHEAPO|CHEAPSKATE
CHECK|CHCK|CHECKER|CHECKERED|CHECKING
CHEER|CHEERFUL|CHEERY
CHEERLEADER|CHEERLEADING
CHEMICAL|CHEMA|CHEM|CHEMIST|CHEMISTRY
CHESAPEAKE|CHESAPAKE
CHEVROLET|CHEVROLETBUICK|CHEVROLETCADILLAC|CHEVROLETOLDSMOBILE|CHEVY|CHVRLET
CHICAGO|CHCAGO
CHILDCARE|CHILDCA|CHILDCAR|CHLDCARE|CHLDCR|CHLDCRE
CHILD|CHILDERN|CHILDRE|CHILDREN|CHLD|CHLDREN|CHLDRN|CHILDHOOD|CHILDHD|CHLDHD|CHLDHOOD|TODDLE|TODDLER
CHINESE|CHNESE|CHINESEAMERICAN
CHIROPRACTY|CHIROPRATIC|CHIROP|CHIROPR|CHIROPRA|CHIROPRAC|CHIROPRACT|CHIROPRACTC|CHIROPRACTI|CHIROPRACTIC|CHIROPRACTICE|CHIROPRACTOR|CHIROPRCTC|CHIROPRCTIC|CHRIOPRACTIC|CHROPRACTIC|CHRPRACTIC|CHRPRCTC|CHRPRCTIC
CHICKEN|CHKN
CHOCOLATE|CHOC|CHOCK|CHOCLAT|CHOCOLAT|CHCLAT|CHOCOLATIER
CHOOSE|CHOOSING|CHOSE|CHOSEN
CHOP|CHOPPED|CHOPPER|CHOPPING
CHORAL|CHORALE|CHOIR
CHAPEL|CHPEL|CHPL
CHRIST|CHRISTIAN|CRIST|CRISTIAN|CHRISTIN|CRISTIN|CHRI|CHRISTN
CHRISTINA|CRISTINA|CHRISTINE|CRISTINE
CHRISTINO|CRISTINO
CHRIS|CHRISTOPHER|CRISTOPHER|CHRISTO|CRISTO|CHRISTOBAL|CRISTOBAL
CHRISTIE|CRISTIE|CHRISTY|CRISTY
CHRONIC|CRONIC
CHRYSLER|CHRYSLERPLYMOUTH
CHURCH|CHCH|CHRC|CHURC|CHRCH|CHRUCH|CHURH|CULT|CHURCHE
CINCINNATI|CINCINATTI|CNCINNATI|CNCNNATI
CINEMA|CINEMATIC|CINEMATOGRAPHY
CITIZEN|CTIZEN|CTZEN|CTZN
CIVIC|CVIC
CIVIL|CVIL
CLASSIC|CLASSCAL|CLASSE|CLASSI|CLASSICA|CLASSICAL|CLASSICO|CLASSIE|CLASSIQUE|CLASSY|CLSSCAL
CLEAN|CLEAING|CLEANCO|CLEANE|CLEANED|CLEANER|CLEANEST|CLEANG|CLEANI|CLEANIG|CLEANIN|CLEANING|CLEANNG|CLEANNING|CLEANOUT|CLEANPRO|CLEANRITE|CLEANROOM|CLEANSWEEP|CLEANTECH|CLEANUP|CLEANWAY|CLNNG|CLNING|CLNG|CLNR|CLNUP|DECONTAMINATION|KLEAN|KLEANER|KLEANING|CLEANSE|CLEANSER|CLEANSING|KLEEN|KLEENER|KLEENING|TIDY
CLEAR|CLEARED|CLEARING|CLRING|KLEER
CLEARWATER|CLEARWTER
CLERGY|CLERICAL
CLIMB|CLIMBER|CLIMBING|CLIMER
CLINIC|CLINI|CLINICA|CLINICAL|CLINICIAN|CLINICO|CLINIQUE|CLNC|CLNCAL|CLNCL|CLNIC|CLNICAL|KLINIC
CLOSE|CLOSED|CLOSER|CLOSING|CLOSURE
CLOTH|CLOTHE|CLOTHIER|CLOTHIN|CLOTHING|KLOTH|KLOTHE|KLOTHING|TEEZ|TEXTILE|TROUSER|TSHIRT
COACH|COACHE|COACHING|COACHLIGHT|COACHMAN|COACHNG|COACHWORK
COAL|COALE|COALFIELD|COALMINE
COALITION|COALITN|COALI|COALTN
COLLISION|COLLISON|COLLISSION|CLLISION|CLLSION
COAST|COAST2COAST|COASTAL|COASTER|COASTL|COASTLAND|COASTLINE|COASTSIDE|COSTAL|COSTALE
COAT|COATE|COATED|COATER|COATI|COATIN|COATING
COBBLE|COBBLER|COBBLESTONE|COBLESKILL
COCHRAN|COCHRANE|COCH|COCK|COCKE|COCKER|COCKERHAM|COCKERILL|COCKRELL|COCKRILL|COCKRUM|COCKY
COCO|COCOA|COCONINO|COCONUT
CODE|CODED|CODER|CODEX|CODI|CODING
COFFEE|COFFEEHOUSE|COFEE|COFF|COFFE|COFFEY
COFFER|COFER
COGNITION|COGNITIVE
COHERENT|COHESION|COHESIVE|COHERE
COIFFURE|COIFFEUR
COIN|COINER|COINOP|NUMISMATIC
COKE|COCA|COCACOLA|COKER|COLA
COLD|COLDEN|COLDIRON|COLDREN|COLDSPRING|COLDSTONE|COLDSTREAM|COLDWATER|COLDWELL|COLDER
COLLABORATE|COLAB|COLLAB|CLLABORATIVE|CLLBORATIVE|CLLBRATIVE|CLLBRTIVE|COLLABORATION|COLLABORATIVE|COLLABRATIVE|COLLABRTIVE|COLLA
COLLAR|COLLER|COLLARD|KOLLAR
COLLECT|CLLC|CLLCTABLE|CLLCTBL|CLLCTBLE|CLLCTIBLE|CLLCTION|CLLCTIVE|CLLCTN|CLLCTON|CLLECTABLE|CLLECTIBLE|CLLECTION|CLLECTIVE|CLLECTN|COLLECTA|COLLECTAB|COLLECTABL|COLLECTABLE|COLLECTED|COLLECTI|COLLECTIB|COLLECTIBL|COLLECTIBLE|COLLECTING|COLLECTIO|COLLECTION|COLLECTIVE|COLLECTN|COLLECTOR|COLLEC|KOLLECTABLE|KOLLECTIBLE|KOLLECTION
COLLEGE|COLLEG|CLLEGE|CLLG|CLLGE|COLLEGIATE|COLLEGIUM|COLLAGE|COLLAGEN|COLLGE|KOLLEGE
COLLIE|COLLI|COLLIER|COLLIERIE|COLLIERVILLE|COLLYER|COLYER
COLOMBIA|COLOMBIAN|COLOMBIANA|COLOMBIANO|COLOMBO|COLUMBA|COLUMBIA|COLUMBIAN|COLUMBIANA|COLUMBINE|COLUMBO|COLUMBU
COLON|COLONA|COLONEL|COLONIC|COLONNA|COLORECTAL
COLONY|COLNY|COLONIA|COLONIAL|COLONIE
COLOR|COLORA|COLORAD|COLORAMA|COLORE|COLORED|COLORFUL|COLORING|COLORWORK|COLOUR
COLOSSEUM|COLOSIMO|COLOSSAL|COLOSSU
COLUMN|COLUM|COLUMB|COLUMNA|COLUNGA
COMANCHE|COMMANCHE
COMBAT|COMBATIVE
COMB|COMBE|COMBEE|COMBER
COMBINE|COMBINATION|COMBINED|COMBINING|COMBO
COMBUST|COMBUSTION|COMBUSTABLE
COME|COMING|COMME
COMEDIAN|COMEDY|COMIC|COMIDA|COMIX
COMFORT|COMFORTABLE|COMFORTER|COMFORTING|COMFY|CONFORT|KOMFORT
COMMAND|COMMANDER|COMMANDERY|COMMANDMENT|COMMANDO
COMMEMORATE|COMMEMORATIVE
COMMENCE|COMMENCEMENT
COMMISSION|COMISION|COMMISION|COMMISSARY|COMMISSIONED|COMMISSIONER|COMMISSIONING
COMMIT|COMMITEE|COMMITMENT|COMMITT|COMMITTE|COMMITTED|COMMITTEE|CMMITTEE|CMMTTEE|CMTE|COMITE
COMMODITY|COMMODITIE|COMMODE
COMMON|CMMON|CMMN|CMN|COMMN
COMMONWEALTH|COMMONWALTH|COMMONWLTH
COMMOTION|COMOTION
COMMERCE|COMMRCE|CMMERCE|COMMERCIA|COMMER|COMMERC|COMMERCIAL|COMMERCL|COMMERICAL|COMMERICIAL|CMMRC|CMMRCE|CMMRCIAL|CMMRCL|CMRC|CMRCE|CMRCL|COMMRCL|COMRCL|ECOM|ECOMM|ECOMMERCE|COMERCIAL|COMERCIALIZADORA|COMERCIO
COMMUNICATE|COMMINICATION|CMMNCATION|CMMNCTION|CMMNCTN|CMMNCTON|CMMNICATION|CMMUNICATION|COMMCTN|COMMNCTN|COMMUNCATION|COMMUNCIATION|COMMUNCTION|COMMUNCTN|COMMUNCTON|COMMUNI|COMMUNIC|COMMUNICA|COMMUNICAT|COMMUNICATI|COMMUNICATING|COMMUNICATIO|COMMUNICATION|COMMUNICATN|COMMUNICATON|COMMUNICATOR|COMMUNICTION|COMMUNIQUE|COMUNICACIONE|COMUNICATION
COMMUNITY|COMMUNTIY|CMMNITIE|CMMNITY|CMMNTIE|CMMNTY|CMMTY|CMMUNITIE|CMNTY|COMMUNTIE|COMMUNIT|COMMUNTY|COMNTY|COMMUNE|COMUNIDAD|COMUNIDADE|COMUNITARIO|COMUNITY|COMMNITY|COMMNTY|COMMUNITIE
COMMUTE|COMMUTER
COMPACT|COMPACTION|COMPACTOR
COMPANION|CMPANION|CMPNION|COMPANIONSHIP|COMPADRE
COMPARE|COMPARATIVE|COMPARISON
COMPASS|COMPAS|COMPASSION|COMPASSIONATE|COMPASSNATE
COMPEL|COMPELLING
COMPENSATION|CMPNSTION|COMPEAN
COMPETE|COMPETITION|COMPETITIVE|COMPETITOR|COMPETTIVE
COMPETENT|COMPETENCY
COMPLAIN|COMPLAINING|COMPLAINT
COMPLETE|CMPLETE|CMPLT|COMPLEAT|COMPLETELY|COMPLETION|KOMPLETE
COMPLEX|CMPLEX|COMPLEXION
COMPLIANCE|CMPLANCE|CMPLIANCE|CMPLNCE|COMPLIANT|COMPLNCE|COMPLY
COMPLIMENT|COMPLIMENTARY|COMPLEMENT|COMPLEMENTARY
COMPONENT|CMPNENT|CMPONENT|CMPNNT|COMPO|COMPONET
COMPOSE|COMPOSER|COMPOSITE|COMPOSITION
COMPOST|COMPOSTING
COMPOUND|COMPOUNDING
COMPREHENSIVE|CMPRHNSIVE|COMPRHENSIVE|COMPRHNSIVE
COMPRESS|COMPRES|COMPRESSED|COMPRESSION|COMPRESSOR
COMPUTER|CMPT|CMPTER|CMPTR|CMPU|CMPUTER|COMPUTERIZED|COMPUT|COMPUTADORA|COMPUTATION|COMPUTATIONAL|COMPUTE|COMPUTECH|COMPUTEK|COMPUTERLAND|COMPUTERWORK|COMPUTING|COMPUTOR|COMPUTR|COMPTECH|COMPTER|COMPTR|COMPU|COMPUNET|CPU|KOMPUTER
COMTEC|COMTECH|COMTEK
CONCEAL|CONCEALED|CONCEALMENT
CONCENTRATE|CONCENTRATED
CONCEPT|CNCEPT|CNCPT|CONCEPTO|CONCEPTUAL|CONCEPTZ|CONCPT|KONCEPT|CONCEPTION|CONCEPCION
CONCERN|CONCERNED
CONCERT|CNCERT|CNCRT|CONCERTO
CONCESSION|CONCESSIONAIRE|CONSESSION
CONCIERGE|CNCERGE|CNCIERGE|CNCRGE
CONCILIATION|CONCILIO
CONCOCT|CONCOCTION
CONCORD|CONCORDE|CONCORDIA|CONCHORD
CONCOURSE|CONCOUR
CONCRETE|CONCR|CONCRE|CONCRET|CONRETE|KONCRETE
CONCUR|CONCURRENT
CONCUSS|CONCUSSION
CONDE|CONDI|CONDIE
CONDITION|CNDTNING|CONDITIONED|CONDITIONER|CONDITIONI|CONDITIONIN|CONDITIONING|CONDIT|CONDITI|CONDITIO
CONDO|CNDMINIUM|CNDMNIUM|CNDMNM|CNDMNUM|CNDO|CNDOMINIUM|CONDIMINIUM|CONDMNM|CONDOM|CONDOMI|CONDOMIN|CONDOMINI|CONDOMINIO|CONDOMINIU|CONDOMINIUM|CONDOMINM|CONDOMINUM|CONDOMIUM|CONDOMNIUM|CONDOMNM|CONDON|CONDOR
CONDUCT|CONDUCTIVE|CONDUCTOR|CONDUIT
CONE|CONIC|CONICAL
CONEY|CONY
CONFECTION|CONFECTIONARY|CONFECTIONER|CONFECTIONERY
CONFEDERATE|CONFEDERATION
CONFER|CNFERENCE|CNFRENCE|CNFRNC|CNFRNCE|CONFERENCE|CONFERENCING
CONFESS|CONFESSOR|CONFESSION
CONFIDENT|CONFIDENCE|CONFIDENTIAL|CONFIDNTIAL
CONFIGURE|CONFIG|CONFIGURATION
CONFINE|CONFINEMENT
CONFLICT|CNFLICT
CONFUSE|CONFUSED|CONFUSION
CONGO|CONGOLESE
CONGREGATE|CNGREGATION|CNGRGATION|CNGRGATIONAL|CNGRGTION|CNGRGTIONAL|CNGRGTN|CNGRGTNAL|CNGRGTONAL|CONGREGATION|CONGREGATIONAL|CONGREGATN|CONGREGTN|CONGRG|CONGRGTION|CONGRGTN|CONGREG|CONGREGACION
CONGRES|CNGRES|CONGRESSIONAL|CONGRESSMAN|CONGRESSWOMAN
CONNECT|CNNCTION|CNNCTN|CNNCTON|CNNECTION|CONECTION|CONEX|CONEXION|CONNCTN|CONNEC|CONNECTED|CONNECTICONNECTING|CONNECTIO|CONNECTION|CONNECTIVE|CONNECTIVITY|CONNECTN|CONNECTON|CONNECTOR|CONNEX|CONNEXION|CONNEXTION|KONNECT|KONNECTION
CONNELLY|CONNELY|CONELLY|CONELY|CONNOLLY|CONOLY|CONOLLY|CONNOLY
CONNI|CONNIE|CONNY
CONNOR|CONOR
CONQUER|CONQUERING|CONQUEROR|CONQUEST|CONQUISTADOR
CONSCIOUSNES|CONSCIENCE|CONSCIOU
CONSENT|CONSENSU
CONSERVE|CNSERVATION|CNSRVATION|CNSRVTION|CNSRVTN|CONSERV|CONSERVA|CONSERVANCY|CONSERVATION|CONSERVATIVE|CONSERVATOR|CONSERVATORY|CONSRVTN
CONSIDER|CONSIDERED
CONSIGNMENT|CONSIGMENT|CNSGNMENT|CNSGNMNT|CNSIGNMENT|CONSIGN|CONSIGNMEN|CONSIGNOR
CONSIST|CONSISTENT|CONSISTING|CONSISTORY
CONSOLIDATE|CONSOLIDATED|CONSOLIDATION|CONSOLIDATOR|CONSOL|CONSOLDATED|CONSOLDTED|CONSOLE|CONSUELA|CONSUELO
CONSORT|CNSMR|CNSORTIUM|CNSRTIUM|CONSORTIUM|CONSORCIO
CONSPIRE|CONSPIRACY
CONSTABLE|CONSTABULARY
CONSTITUTION|CONSTITUTIONAL
CONSTRUCT|CONSTRUCTION|CNST|CNSTR|CNSTRCTION|CNSTRCTN|CNSTRUCTION|CONSRTUCTION|CONSRUCTION|CONSTRUCTI|CONSTRUCTIN|CONSTRUCTING|CONSTRUCTIO|CONSTRUCTIONINC|CONSTRUCTIONLLC|CONSTRUCTIVE|CONSTRUCTN|CONSTRUCTON|CONSTRUCTOR|CONSTRUCTORA|CONSTRUSTION|CONSTRUTION|CONSTRUX|CONSTUCTION|CONSTURCTION|CONSTR|CONSTRCTION|CONSTRCTN|CONSTRACTION|CONSTRCUTION|CONSTRN|CONSTRU|CONSTRUC|CONSTRUCCION|CONSTRUCCIONE|CONSTRUCION|CONSTRUCITON|CONTRUCTION|CONTSTRUCTION|COSNTRUCTION|COSTAR|COSTRUCTION|DECONSTRUCTION|KONSTRUCTION
CONSULT|CNSLTANCY|CNSLNT|CNSLTG|CNSLTN|CNSLTNG|CNSLTNT|CNSULT|CNSULTANCY|CONSULTA|CONSULTAN|CONSULTANTING|CONSULTATION|CONSULTATIVE|CONSULTG|CONSULTI|CONSULTIN|CONSULTING|CONSULTINGINC|CONSULTINGLLC|CONSULTN|CONSULTNG|CONSULTNT|CONSULTORE|CONSUL|CONSULANT|CONSULATE|CONSLNT|CONSLT|CONSLTG|CONSLTING|CONSLTN|CONSLTNG|CONSLTNT|CONSTULTING|CONSUTANT|CONSUTING|CONSUTLING|COSULTING|KONSULTING|CNSLTING|CNSULTING|CONSULTANCY|CONSULTANT
CONSUMER|CONSMR|CONSUMABLE|CONSUME
CONTACT|CNTACT|CONTACTING
CONTAIN|CONTAINED|CONTAINER|CONTAINING|CONTAINMENT
CONTEMPORARY|CNTEMPORARY|CONTEMPORY|CONTEMPRARY|CNTMPORARY|CNTMPRARY|CONTEMPO
CONTEND|CONTENDER
CONTENT|CONTENTMENT|CONTENTO
CONTEST|CONTESTED
CONTEXT|CONTEXTUAL
CONTINENT|CONTINENCE|CONTINENTAL|CONTINENTIAL|CONTINNTAL|CONTNTL
CONTINGENCY|CONTINGENT
CONTINUE|CONTINUATION|CONTINUED|CONTINUING|CONTINUITY|CONTINUOU|CONTINUUM
CONTOUR|CONTOURING
CONTRACT|CNTRACT|CONTRAC|CNTRCT|CNTRCTNG|CNTRCTR|CONTRACTED|CONTRACTER|CONTRACTI|CONTRACTIN
CONTRACTING|CONTRACTION|CONTRACTNG|CONTRACTO|CONTRACTOR|CONTRACTR|CONTRACTUAL|CONTRATISTA|CONTRATOR|CONTRCTNG|CONTRCTOR|CONTRCTR|CONSTRACTING|CONSTRACTOR|CONTACTOR|SUBCONTRACTING|SUBCONTRACTOR
CONTRARY|CONTRARIAN
CONTRIBUTE|CONTRIBUTED|CONTRIB|CONTRIBUTION
CONTROL|CONTRL|CONTRO|CNTRO|CONTROLL|CONTROLLED|CONTROLLER|COMPTROLLER|KONTROL
CONVALESCE|CONVALESC|CONVALENSCENSE|CONVALESCENCE|CONVALESCENT
CONVENIENCE|CNVENIENCE|CNVNENCE|CNVNIENCE|CNVNNCE|CONVENIENT|CONVIENCE|CONVIENT
CONVENTION|CNVENTION|CNVNTION|CNVNTN|CONVENTIONAL|CONVENT
CONVERGE|CONVERGED|CONVERGENCE|CONVERGENT
CONVERSATION|CONVERSE
CONVERT|CONVERSION|CONVERTER|CONVERTIBLE|CONVERTING
CONVEY|CONVEYANCE|CONVEYING|CONVEYOR
CONVICT|CONVICTION
COOK|COOKBOOK|COOKE|COOKED|COOKER|COOKERY|COOKEVILLE|COOKHOUSE|COOKIE|COOKIN|COOKING|COOKMAN|COOKN|COOKOFF|COOKOUT|COOKSEY|COOKSON|COOKWARE
COOL|COOLED|COOLER|COOLEY|COOLG|COOLI|COOLIDGE|COOLIN|COOLING
COOP|COOPER|COOPERAGE|COOPERATION|COOPERATIVA|COOPERATIVE|COOPERMAN|COOPERSBURG|COOPERSMITH|COOPERSTOWN|COOPERTIVE|COOPERATE|COUP|COUPE
COORDINATE|COORD|COORDINATED|COORDINATING|COORDINATION|COORDINATOR|CORDINATOR
COOT|COOTER|COOTIE
COPA|COPACABANA
COPE|COPING|COPPIN|COPPINGER|COPPLE
COPELAND|COPLAN|COPLAND
COPPAGE|COPPEDGE
COPPER|COPER|COPPERA|COPPERFIELD|COPPERHEAD|COPPERLEAF|COPPERSMITH|COPPERSTATE|COPPERSTONE|COPPERWOOD
COPT|COPTIC
COPY|COPU|COPYCAT|COPYING|COPYRIGHT|COPYWRITER|COPYWRITING|COPIER|COPIE|PHOTOCOPY|PHOTOCOPIER
COQUETTE|COQUETTISH
CORAZON|CORAZONE
CORBEL|CORBELL
CORBET|CORBETT|CORBIT|CORBITT
CORD|CORDE|CHORD|CHORDE|CORDON
CORDOBA|CORDOVA
CORDRAY|CORDREY|CORDRY
CORE|CORING|CORED
COREEN|COREN|CORENE
COREY|CORI|CORY|CORIE
CORIN|CORINA|CORINE|CORINNA|CORINNE|CORRIN|CORRINA|CORRINE
CORINTH|CORINTHIAN
CORK|CORKER|CORKERN|CORKERY|CORKEY|CORKLE|CORKSCREW|CORKY|CORKED
CORLEY|CORLI|CORLIS
CORMAC|CORMACK
CORN|CORNBREAD|CORNE|CORNED|CORNFIELD|CORNHOLE|CORNHUSKER|CORNICE|CORNING|CORNISH|CORNMAN
CORNEL|CORNELL
CORNELI|CORNELIA|CORNELIO|CORNELIOU|CORNELIU
CORNER|CONER|CONERLY|CONERSTONE|CORNERSTONE|CORNR|CRNER|KORNER|KORNERSTONE
CORNET|CORNETT|CORNETTE
CORPU|CORPUS|CORPUZ
CORRAL|CORRALE
CORRECT|CORECTN|CORRECTION|CORRECTIONAL|CORRECTIVE
CORRESPOND|CORRESPONDENCE|CORRESPONDENT
CORRODE|CORROSION
CORRUGATE|CORRUGATED
CORSICA|CORSICAN|CORSICANA
CORTLAND|CORTLANDT
COSMETIC|COSMECEUTICAL|COSMEDIC|COSMET|COSMETIQUE|COSMETOLOGIST|COSMETOLOGY|COSMOTOLOGIST|COSMOTOLOGY|COSMT|COSMTC
COSMIC|COSMO|COSMOS
CONSTANTIN|CONSTATINE|COSTANTINI|COSTANTINO|KONSTANTIN|KONSTANTINE|CONSTANTINE|CONSTANTINO
COSTANZA|COSTANZO
COSTUME|COSTUMED|COSTUMING
COZY|COSY|COSI|COSEY|COZIE|KOZY
COTTAGE|CTTAGE|CTTGE
COTTON|COTON|COTTONE|COTTONTAIL|COTTONWOOD
COUNCIL|CNCIL|COUNCILING|COUNCILMAN|COUNCL|COUNCELING|COUNCI|COUNSE|COUNSEL|COUNSELI|COUNSELIN|COUNSELING|COUNSELLING|COUNSELLOR|COUNSELNG|COUNSELOR|COUNSIL|COUNSLG|COUNSLING|COUNSLNG|COUNSLR|COUNSULTING|COUNCE|COUNC|CNCL|CNSEL|CNSELING|CNSELNG|CNSELOR|CNSL|CNSLG|CNSLING|CNSLNG|CNSLOR|CNSLR|CONSECO|CONSIGLIO|CONSELING|CUNCIL|CUNSEL|CUNSELING|CUNSELOR
COUNT|COUNTDOWN|COUNTER|COUNTERPOINT|COUNTERTOP|COUNTING|COUNTR
COUNTRY|CNTRY|COUNTRYMAN|COUNTRYSIDE|COUNTRYVIEW|COUNTRYWIDE|COUNTRYWOOD|COUNTRIE|CONTRY|COUNRTY|CTRY|KOUNTRY
COUNTY|CNTY|COUNTYLINE|COUNTYWIDE|COUNTES|COUNTIE|CUNTY
COUPLE|COUPLING
COURAGE|COURAGEOU
COURIER|COURRIER|CURIER|CURRIER
COURSE|COURSEY
COURT|COURTE|COURTER|COURTHOUSE|COURTLAND|COURTLANDT|COURTROOM|COURTSIDE|COURTYARD
COURTNEY|CORTNEY
COUSIN|COUSINE|CUZ|CUZIN|CUZZIN
COUSINEAU|COUSINO
COUTURE|COUTURIER
COVENANT|CONVENANT|COVEN|COVENTRY|CVENANT
COVER|COVERAGE|COVERALL|COVERDALE|COVERED|COVERI|COVERIN|COVERING|COVERT|COVERUP|CVRNG
COVET|COVETOUS
COW|COWBELL|COWBOY|COWGIRL|COWHERD|CWBOY
COWL|COWLE|COWELL|COWELED
COWORK|COWORKING|COWORKER
CRAB|CRABAPPLE|CRABB|CRABBE|CRABBY|CRABHOUSE|CRABILL|CRABTREE
CRACK|CRACKED|CRACKEN|CRACKER|CRACKERJACK|KRACKER|KRACKEN|KRAKEN
CRAFT|CRAFTED|CRAFTER|CRAFTING|CRAFTIQUE|CRAFTMAN|CRAFTMASTER|CRAFTMEN|CRAFTON|CRAFTSMAN|CRAFTSMANSHIP|CRAFTSMEN|CRAFTWORK|CRAFTY|CRFT|KRAFT|KRAFFT|KRAFTER|KRAFTY
CRANBERRY|CRANBERRIE|CRANBROOK|CRANBURY
CRANDALL|CRANDELL|CRANDAL
CRANE|CRAIN|CRAINE|CRANER|CRANEY
CRANIAL|CRANIOFACIAL|CRANIOSACRAL|CRANIUM
CRANK|CRANKSHAFT|CRANKY
CRAP|CRAPPIE|CRAPPY|CRAPPE
CRASH|CRASHING|CRASHED
CRATE|CRATER|CRATING
CRAVE|CRAVEN|CRAVER|CRAVEY|CRAVIN|CRAVING
CRAW|CRAWDAD|CRAWDADDY|CRAWFISH|CRAWFORD|CRAWFORDSVILLE|CRAY|CRAYFISH|CRAYDAD
CRAWL|CRAWLER|CRAWLSPACE
CRAZE|CRAZED|CRAZY
CREAM|CREAMER|CREAMERY|CREAMY|CREME|CRMRY|KREAM|KREAMER
CREATE|CRATION|CRATIVE|CREACIONE|CREAT|CREATEABOOK|CREATED|CREATI|CREATING|CREATIO|CREATION|CREATIONZ|CREATIV|CREATIVA|CREATIVE|CREATIVELY|CREATIVITY|CREATIVO|CREATN|CREATON|CREATOR|CREATV|CREATVE|CRTION|CRTIVE|KREATION|KREATIONZ|KREATIV|KREATIVE
CREATURE|CRITTER
CREDENTIAL|CREDENTIALING|CREDIBLE
CREDIT|CRED|CREDENCE|CREDI|CREDITO|CREDITOR
CREEK|CREEKMORE|CREEKSIDE|CREEKSTONE|CREEKVIEW|CREEKWOOD
CREEP|CREEPER|CREEPY
CREMATION|CREMATORIUM|CREMATORY|CRMATION|CRMTION
CREPE|CREP|CREPERIE
CRESCENT|CRESCENDO|CRESCENTA|CRESCENZO
CREST|CREAST|CRESTED|CRESTHAVEN|CRESTHILL|CRESTLINE|CRESTMONT|CRESTON|CRESTONE|CRESTVIEW|CRESTWOOD|CRESWELL|CRST
CRICK|CRICKET|CRICKETT
CRIME|CRIM|CRIMESTOPPER|CRIMINAL|CRIMM|CRIMMIN|CRMNAL
CRIPPLE|CRIPPLED
CRISP|CRISPY|KRISPY
CRITERIA|CRITERION|CRITERIUM
CRITIC|CRITICAL|CRITIQUE|CRTCAL
CRITTENDEN|CRITTENDON|CRITTENTON
CROATIA|CROATAN|CROATIAN
CROC|CROCK|CROCKER|CROCKET|CROCKETT|CROCODILE
CROOK|CROOKE|CROOKED|CROOKER
CROP|CROPPER
CROSS|CROIX|CROSSBOW|CROSSBRIDGE|CROSSCOUNTRY|CROSSCREEK|CROSSCULTURAL|CROSSCUT|CROSSE|CROSSED|CROSSEN|CROSSER|CROSSETT|CROSSFIELD|CROSSFIRE|CROSSFIT|CROSSGATE|CROSSHAIR|CROSSING|CROSSLAKE|CROSSLAND|CROSSLEY|CROSSLIN|CROSSLINK|CROSSMAN|CROSSNG|CROSSON|CROSSOVER|CROSSPOINT|CROSSPOINTE|CROSSROAD|CROSSTOWN|CROSSVILLE|CROSSWALK|CROSSWAY|CROSSWHITE|CROSSWIND|CROSSWOOD|CRSNG|CRSSING|CRSSNG|XING
CROUCH|CROUCHER
CROW|CROWE
CROWD|CROWDED|CROWDER
CROWN|CORONA|CORONADO|CROWNE|CROWNED|CROWNING|CROWNOVER
CRUCIAL|CRUCIBLE
CRUDE|CRUDO
CRUEL|CRUELTY
CRUISE|CRUISEONE|CRUISER|CRUISIN|CRUISING|CRUIZER|CRUSE|CRUSIN|CRUZ|CRUZE|CRUZER|CRUZIN
CRUMB|CRUM|CRUMBLE|CRUMBLEY
CRUNCH|CRUNCHY
CRUSADE|CRUSADER
CRUSH|CRUSHED|CRUSHER|CRUSHING
CRUST|CRUSTY
CRUTCH|CRUTCHER|CRUTCHFIELD
CRY|CRYER|CRYING
CRYO|CRYOGENIC|CRYOTHERAPY
CRYPT|CRYPTIC|CRYPTO
CRYSTAL|CRISTAL|CRYSTALLINE|CRYSTL|CYRSTAL|KRYSTAL
CT|CONNECTICUT|CONNECTCUT|CONNETICUT
CTR|CENTER|CNTER|CNTR|CNTRAL|CENTRAL|CENTRE|CNTRE|CNTRL|CTRL
CUBA|CUBAN|CUBANA|CUBANO
CUBE|CUBED|CUBIC|CUBICLE|CUBICAL|QUBE
CUDDLE|CUDDLY
CULINARY|CLNARY|CULINAIRE|CUISINE|CUSINE
CULL|CULLEN|CULLER|CULLEY
CULPEPER|CULPEPPER
CULTIVATE|CULTIVATED|CULTIVATING|CULTIVATION|CULTIVATOR
CULTURE|CULTRL|CULTU|CULTUR|CULTURA|CULTURAL|CLTRAL|CLTRL|CLTURAL|CLTURE|CULTURED
CULVER|CULVERHOUSE
CUMING|CUMMIN|CUMMING
CUP|CUPBOARD|CUPCAKE|CUPCAKERY|CUPP|CUPPA|KUPCAKE
CURATE|CURATED|CURATOR
CURE|CURATIVE|CURED|CURING
CURB|CURBING|CURBSIDE
CURIOSITY|CURIOSITIE|CURIOUS
CURL|CURLEE|CURLER|CURLEY|CURLIN|CURLING|CURLY
CURRENT|CURRAN|CURRANT|CURREN|CURRENCE|CURRENCY
CURRY|CURREY|CURRIE
CURSE|CURSED
CURVE|CURVED|CURVIN|CURVING|CURVY
CUSH|CUSHING|CUSHION
CUSTODIAL|CUSTODIAN|CUSTODIO|CUSTODY
CUSTOMER|CUSTOME|CSTM|CSTMER|CSTOM|CUSTOMHOUSE|CUSTOMIZATION|CUSTOMIZE|CUSTOMIZED|CUSTOMIZING|CUSTOMZ|CUSTON|CUSTUM|CUSTM|CUSTOM
CUT|CUTLAS|CUTLER|CUTLERY|CUTNG|CUTOFF|CUTRATE|CUTZ|CUTT|CUTTER|CUTTERY|CUTTHROAT|CUTTIN|CUTTING|CUTTINGEDGE|CUTTY
CUTCHEON|CUTCHIN
CUTE|CUTIE
CUTRIGHT|CUTRITE
CYBER|CYBERKNIFE|CYBERNET|CYBERNETIC|CYBERSECURITY|CYBERSPACE|CYBERTECH|CYBORG
CYCLOP|CYCLOPS
CYPRES|CYPRESSWOOD|CYPRIAN
DAD|DADD|DADDY|DADY|DADDIE|DADIE
DAGGER|DAGER
DAILY|DAILEY|DALY
DAIRY|DAIRIE|DAIRYLAND|DAIRYMEN
DAISY|DAISEY|DAISIE
DAKOTA|DAKOTAH
DALMATIAN|DALMATION
DAM|DAMN|DAMM|DANG|DARN
DAMAGE|DAMAGED
DAMIAN|DAMIEN|DAMION
DAMORE|DAMOUR
DAMP|DAMPER|DAMPEN|DAMPED
DAN|DANIEL|DANEIL|DANIAL|DANIELA|DANIELE|DANIELL|DANIELLA|DANIELLE|DANN|DANNI|DANNIE|DANNIELLE|DANNY|DANY|DANYEL|DANYELL|DANYELLE
DANCE|DANCER|DANCESPORT|DANCEWEAR|DANCEWORK|DANCIN|DANCING|DANSE
DANGER|DANGERFIELD|DANGEROUS
DANGLE|DANGLER
DANISH|DANMARK|DENMARK
DANK|DANKER
DANKE|DANKA
DARCY|DARCEY|DARCI|DARCIE|DARSEY
DARE|DARED|DARING
DARK|DARKE|DARKHORSE|DARKNES|DARKNESS|DARKROOM|DARKSIDE|DARKSTAR
DARLENE|DARLEEN|DARLINE
DARRELL|DAREL|DARREL|DARELL
DARREN|DAREN|DARIN|DARRIN|DARRON|DARYN|DEREN
DARRYL|DARRYLL|DARYL|DARYLE|DARYLL|DERREL|DERRELL|DERYL
DART|DARTE|DARTER
DASH|DASHA|DASHBOARD|DASHER|DASHIELL|DASHING|DASHED
DATA|DATABASE|DATACENTER|DATACOM|DATACOMM|DATALINK|DATANET|DATATECH|DATAWORK|DATUM
DATE|DATED|DATELINE|DATING
DAUGHTER|DAUGHTERY|DAUGHTR|DGHTER|DGHTR|DUGHTER
DAUPHIN|DAUPHINE
DAVID|DAIVD|DAVE|DAVI|DAVEY|DAVIDA|DAVIDE|DAVIE|DAVIES|DAVY
DAVILA|DAVILLA
DAWN|DAWNING|DAWNED
DAY|DAYBREAK|DAYLIGHT|DAYLIGHTING|DAYSTAR|DAYTIME|DAYZ
DAYCARE|DAYCAR|DAYCRE|DYCARE
DAYDREAM|DAYDREAMER
DAYLILY|DAYLILIE
DAYSPA|DAYSPRING
DAZE|DAZED|DAZZLE|DAZZLED|DAZZLER|DAZZLING
DE|DELEWARE|DELWARE|DELAWARE
DEACON|DEACONES|DECON|DEACONESS
DEAD|DEADLINE|DEADLY|DEADWOOD|DEATH|DIE|DIEHARD|DIED|DYING
DEAL|DEALE|DEALER|DEALERSHIP|DEALING|DEALR|DEALZ|DLRSHP
DEAR|DEARBORN
DEBATE|DEBATED|DEBATING
DEBONAIR|DEBONAIRE
DEBORA|DBORAH|DBRA|DBRAH|DEBORAH|DEBBI|DEBBIE|DEBBRA|DEBBY|DEBRA|DEBRAH
DEBT|DEBIT|DEBTOR
DEBUT|DEBUTANTE
DECADENCE|DECADENT|DECEDENT
DECEIVE|DECEIVED|DECEIVING|DECEPTION
DECIDE|DECIDED|DECISION|DECISIVE
DECK|DECKARD|DECKED|DECKER|DECKERT|DECKING
DECLARATION|DECLARE
DECOMPRESS|DECOMPRESSION
DECOR|DCOR|DCORATIVE|DCRATIVE|DCRTIVE
DECORATE|DECORAT|DECORATED|DECORATI|DECORATIN|DECORATING|DECORATION|DECORATIVE|DECORATOR
DEDICATE|DEDICATED|DEDICATION
DEEP|DEEPER|DEEPLY|DEEPWATER|DEEPWOOD|DEPTH
DEER|DEERBROOK|DEERCREEK|DEERE|DEERFIELD|DEERING|DEERPARK|DEERPATH|DEERWOOD|DEERY
DEFENSE|DEFENCE|DEFEND|DEFENDER|DEFENSIVE|DFNSIVE
DEFER|DEFERRED
DEFY|DEFIANCE|DEFIANT|DEFICIT
DEFINE|DEFINED|DEFINING|DEFINITE|DEFINITELY|DEFINITION|DEFINITIVE
DELEGATE|DELEGATION
DELI|DELICATESSEN|DELIGROCERY
DELICACY|DELICACIE|DELICATE|DELICE|DELICIA|DELICIOSO|DELICIOU|DELICIOUSLY
DELIGHT|DELIGHTFUL|DELIGHTFULLY|DLGHT|DLIGHT|DLITE
DELIVER|DELIVERANCE|DELIVERED|DELIVERENCE|DELIVERIE|DELIVERING|DELIVERY|DELIVRNCE|DLIVERANCE|DLVERANCE|DLVRANCE|DLVRNCE|DLVRY
DELTA|DLTA
DELUX|DELUXE|DLUX|DLUXE
DEMENSION|DEMENTION|DEMENSIONAL
DEMENT|DEMENTIA
DEMETRIO|DEMETRIOU|DEMETRIU
DEMOCRACY|DEMOCRAT|DEMOCRATIC|DMCRTIC
DEMOGRAPHIC|DEMOGRAPHY
DEMOLITION|DEMOLISH
DEMONSTRATION|DEMONSTRATE
DENOMINATION|DENOMINATIONAL
DENSE|DENSITY
DENT|DENTED
DENTIST|DENISTRY|DENTISTR|DENTISTRY|DENTL|DENTURE|DNTAL|DNTISTRY|DNTL|DNTST|DNTSTRY|TOOTH|DENTAL
DENY|DENIAL|DENIES|DENIED
DEPART|DEPARTED|DEPARTURE
DEPARTMENT|DEPARTME|DEPARTMEN|DEPT
DEPENDABLE|DEPENDBLE|DEPENDENCY|DEPENDENT
DEPICT|DEPICTION
DEPLOY|DEPLOYED|DEPLOYMENT
DEPOSIT|DEPOSE|DEPOSITION|DEPOSITOR|DEPOSITORY
DEPRESS|DEPRESSED|DEPRESSION
DEPUTY|DEPUTIE|DECPTIZE|DEPUTIZED|DEPUTIES
DEREK|DAREK|DARRICK|DERECK|DERIC|DERICK|DERIK|DERREK|DERRICK
DERIVE|DERIVATIVE
DERMAL|DERMATLOGY|DERMATOLOGIC|DERMATOLOGICAL|DERMATOLOGIST|DERMATOLOGY|DERMATOPATHOLOGY|DERMA|DERMAGRAPHIC|DRMATOLOGY|DRMTLOGY|DRMTOLOGY
DESCEND|DESCENDANT|DESCENT
DESERT|DESSERT|DSERT
DESERVE|DESERVED|DESERVING
DESIGN|DESGIN|DESGN|DESGR|DESIGHN|DESIGNBUILD|DESIGNE|DESIGNED|DESIGNER|DEISGN|DESIGNING|DESIGNLLC|DESIGNSCAPE|DESIGNWORK|DESIGNZ|DEZIGN|DEZIGNZ|DEZINE|DISIGN|DSGN|DSGNED|DSGNER|DSGNR|DSIGN|DSIGNER|DZIGN|DZINE
DESIGNATE|DESIGNATED
DESIRE|DESIR|DESIRABLE|DESIRAE|DESIREE
DESK|DESKTOP
DESTINY|DESTINE|DESTINED|DESTINEE|DESTINI|DESTINIE|DESTINO|DSTINY|DESTINATION
DESTROY|DESTROYER|DESTRUCTION|DESTRY|DESTROYED
DETACH|DETACHMENT
DETAIL|DETAI|DETAILED|DETAILER|DETAILI|DETAILIN|DETAILING|DETAILNG|DETAILZ|DETAL|DETALING|DTAIL|DTAILING|DTILING|DTLING|DTLNG
DETECT|DETECTION|DETECTIVE|DETECTOR|DETENTION|DTCTION
DETER|DETERMINATION|DETERMINED|DETERRENT
DETROIT|DTROIT
DEVELOP|DEVEL|DEVELOMENT|DEVELOPE|DEVELOPED|DEVELOPEMENT|DEVELOPEMNT|DEVELOPM|DEVELOPME|DEVELOPMEN|DEVELOPMENTALLY|DEVELOPMENTLLC|DEVELOPMNT|DEVELPMENT|DEVELPMNT|DEVELPMNTAL|DEVELPOMENT|DEVLOPMENT|DEVLP|DEVLPMNT|DEVMNT|DVELOPER|DVELOPMENT|DVELOPMENTAL|DVL|DVLOPER|DVLOPMENT|DVLOPMENTAL|DVLP|DVLPER|DVLPMENT|DVLPMENTAL|DVLPMNT|DVLPMNTAL|DVLPMT|DEVELOPER|DEVELOPING|DEVELOPMENT|DEVELOPMENTAL
DEVIANCE|DEVIANT
DEVIL|DEVILLE|DIABLO
DEVOTE|DEVOTED|DEVOTION|DEVOTIONAL
DIABETIC|DIABETE|DIABETES
DIAGNOSTIC|DGNOSTIC|DGNSTC|DGNSTIC|DIAGNOSI|DIAGNSTC|DIAGNSTIC
DIAMOND|DIAMONDBACK|DIAMONDHEAD|DIAMONDROCK|DIAMONDZ
DIARY|DIARIE
DIESEL|DEISEL|DIESL
DIET|DIETARY|DIETER|DIETETIC|DIETITIAN
DIETRICH|DIETRICK
DIFF|DIFFERENCE|DIFFERENTIAL|DIFFERENT
DIFFUSION|DIFFUSE
DIG|DIGG|DIGGER|DIGGIN|DIGGING|DIGGITY|DUG
DIGEST|DIGESTIVE
DIGITAL|DGITAL|DGTAL|DIGIT|DIGITALLY|DIGITECH|DIGITIAL|DIGITIZING|DIGITIZE
DIGNITY|DIGNIFIED
DIMENSION|DIMENSIONAL|DMNSION|DMNSON
DINER|DINE|DINNER|DINING|DINNING|DNING
DING|DINGE|DINGER|DINGES|DINGLE|DINGLER|DINGMAN|DINGO|DINGU|DINGED
DIOCESE|DIOCESAN
DIPLOMAT|DIPLOMACY|DIPLOMATIC
DIPPED|DIPPER|DIPPIN|DIPPING
DIRECT|DIRCTRY|DIREC|DIRECTCOM|DIRECTED|DIRECTION|DIRECTIONAL|DIRECTIVE|DIRECTLY|DIRECTO|DIRECTOR|DIRECTORIE|DIRECTORY|DIRECTV|DIREXION|DRECT
DIRT|DIRTBAG|DIRTBUSTER|DIRTWORK|DIRTY|DURTY
DISABLITY|DISAB|DISABILITIE|DISABILITY|DISABLE|DISABLED|DISADVANTAGED|DSB|DSBLED|DSBLITY|DSBLTIE
DISAPPEAR|DISAPPEARING
DISASTER|DISASTROUS|DSASTER|DSSTER
DISBURSE|DISBURSEMENT
DISCIPLE|DISCIPLESHIP|DISCIPLINE|DISCIPLINED
DISCLAIM|DISCLAIMER|DISCLAIMED
DISCLOSE|DISCLOSED|DISCLOSURE
DISCO|DISCOTECA|DISCOTHEQUE
DISCOUNT|DISCOUNTED|DISCOUNTER
DISCOVER|DISCOVERED|DISCOVERIE|DISCOVERING|DISCOVERY|DSC|DSCVERY
DISCREET|DISCRETE
DISCUSS|DISCUSSION
DISEASE|DSEASE|DISEASED|DISORDER|DISORDERED|DSRDER
DISGUISE|DISGUISED
DISH|DISHE|DISHER|DISHMAN
DISK|DISC
DISMANTLE|DISMANTLER|DISMANTLING
DISPATCH|DISPATCHER|DISPATCHING
DISPENSARY|DISPENSER|DISPENSING
DISPOSE|DISPOSABLE|DISPOSAL|DISPOSITION|DSPSAL
DIPUTE|DISPUTED|DSPUTE
DISRUPT|DISRUPTIVE
DISSOLVE|DISSOLUTION|DISSOLVED
DISTANCE|DISTANT
DISTILLED|DISTILLER|DISTILLERIE|DISTILLERY|DISTILLING|DISTLER
DISTINCT|DISTINCTION|DISTINCTIVE|DISTINCTIVELY|DISTINCTLY|DISTINGUISHED|DSTNCTIVE
DISTRACT|DISTRACTED|DISTRACTION|DISTRCT
DISTRES|DISTRESSED|DISTRESSING
DISTRIBUTE|DISTIBUTOR|DISTRIB|DISTRIBU|DISTRIBUIDORA|DISTRIBUT|DISTRIBUTED|DISTRIBUTER|DISTRIBUTI|DISTRIBUTIN|DISTRIBUTIO|DISTRIBUTION|DISTRIBUTO|DISTRIBUTORSHIP|DISTRO|DISTRUBUTING|DISTRUBUTION|DISTRUBUTOR|DSTR|DSTRBTR|DISTR|DISTRIBUTOR
DISTRICT|DISTRIC|DSTRCT
DITCH|DITCHING
DIVA|DIVAZ
DIVE|DIVEN|DIVER|DIVING
DIVERGENT|DIVERSE|DIVERSEY|DIVERSFD|DIVERSFIED|DIVERSICARE|DIVERSIFED|DIVERSIFICATION|DIVERSIFIED|DIVERSIFY|DIVERSION|DIVERSITIE|DIVERSITY|DIVIDE|DIVIDED|DIVISADERO|DIVISI|DIVISIO|DIVISION|DIVISON|DVDEND|DVERSFD|DVID|DVRSFD
DIVINE|DEVINE|DIVIN|DIVINA|DIVINELY|DIVINITY|DIVINO|DVINE
DIVORCE|DIVORCED|DVRCE
DIXIE|DIXIELAND
DOCK|DOCKEN|DOCKER|DOCKERY|DOCKIN|DOCKING|DOCKSIDE
DOCTOR|DCTOR|DCTR|DOCKTER|DOCKTOR|DOCTER|DOKTOR
DOCUMENT|DCUMENT|DOCU|DOCUMENTARIE|DOCUMENTARY|DOCUMENTATION
DODGE|DDGE|DODGEN|DODGER
DOG|DOGG|DOGGIE|DOGGONE|DOGGY|DOGHOUSE|DOGTOWN|DOGWATCH|DOGWOOD|DOGZ|CANINE|CNINE|DAWG|DAWGZ
DOING|DOIG|DOIN|DOIT|DOITALL|DOITYOURSELF
DOLCE|DOLCI
DOLL|DOL|DOLLED|DOLLEY|DOLLHOUSE|DOLLIE|DOLLY|DOLLZ
DOLLAR|DLLAR|DOLAR|DOLLA
DOLOR|DOLORE
DOMAIN|DOMAINE|DOMAN
DOMESTIC|DOMICILE
DOMINANT|DOMINATE|DOMINATION|DOMINATOR
DOMINICAN|DOMINCAN|DOMINICANA|DOMINICANO
DOMINION|DMNION
DONALD|DONALDSON|DONALSON
DONATE|DONAT|DONATI|DONATION|DONER|DONOR
DONERIGHT|DONERITE
DONNI|DONNIE|DONNY
DONOGHUE|DONOHO|DONOHOE|DONOHUE
DOOR|DOORMAN|DOORSTEP|DOORWAY
DORIAN|DORIC
DORM|DORMITORY
DOROTHEA|DOROTHY|DORTHA|DORTHEA|DORTHY
DOT|DOTT|DOTTED|DOTTI|DOTTIE|DOTTY|DOTY|DOTCOM
DOUBLE|DOUBLED|DOUBLEDAY|DOUBLETREE
DOUGH|DOUGHBOY|DOUGHNUT|DONUT
DOUG|DOUGLAS
DOVE|DOVER|DOVETAIL|DOVID|DOVIE
DOWN|DOWNARD|DOWNE|DOWNEAST|DOWNEN|DOWNER|DOWNEY|DOWNHILL|DOWNHOLE|DOWNHOME|DOWNIE|DOWNING|DOWNINGTOWN|DOWNLOAD|DOWNRIVER|DOWNSTAIR|DOWNSTATE|DOWNSTREAM|DOWNTIME|DOWNTOWN|DOWNTOWNER|DOWNUNDER|DWNTWN
DRAFT|DRAFTG|DRAFTING|DRAUGHT|DRFTG
DRAGON|DRAGONFIRE|DRAGONFLIE|DRAGONFLY|DRAGOO|DRAGOON|DRGON
DRAIN|DRAINAGE|DRAING|DRN
DRAMA|DRAMATIC
DRAPE|DRAPER|DRAPERIE|DRAPERY
DRAW|DRAWN|DRAWER|DRAWING|DRW
DREAD|DRED
DREAM|DREAMBUILDER|DREAMCATCHER|DREAMER|DREAMHOME|DREAMHOUSE|DREAMIN|DREAMING|DREAMLAND|DREAMLINE|DREAMMAKER|DREAMSCAPE|DREAMTIME|DREAMWEAVER|DREAMWORK|DREAMWORLD|DREAMY|DREAMZ
DREDGE|DREDGING|DREGER
DRENNAN|DRENNEN|DRENNON
DRES|DRESSAGE|DRESSE|DRESSED|DRESSEL|DRESSER|DRESSING|DRESSLER|DRESSMAKER|DRESSMAKING
DREW|DREWE|DREWERY|DREWRY
DREXEL|DREXLER
DRIFT|DRIFTER|DRIFTING|DRIFTLES|DRIFTWOOD
DRIGG|DRIGGER
DRILL|DRILLER|DRILLING
DRINK|DRINKARD|DRINKER|DRINKING|DRINKWATER|DRUNK|DRUNKEN
DRIP|DRIPPING
DRISCOLL|DRISKELL|DRISKILL
DR|DRIVE|DRIV|DRIVEAWAY|DRIVEIN|DRIVEINN|DRIVELINE|DRIVEN|DRIVER|DRIVESHAFT|DRIVETHRU|DRIVETRAIN|DRIVEWAY|DRIVIN|DRIVING|DRV|DRVER|DRVING|DRVNG|DRVR
DROP|DROPCATCHCOM|DROPIN|DROPPER|DROPPING
DRUG|DRUGGIST|DRUGSTORE
DRUM|DRUMHELLER|DRUMM|DRUMMER|DRUMMING|DRUMMOND|DRUMRIGHT
DRY|DRI|DRIE|DRIED|DRIER|DRYCLEAN|DRYCLEANER|DRYCLEANING|DRYDEN|DRYDOCK|DRYE|DRYER|DRYING|DRYSDALE
DRYWALL|DRYWAL|DRYWALLING|DRYWLL
DUAL|DUALL
DUANE|DUAINE|DUWAYNE|DWAIN|DWAINE|DWAN|DWANE|DWAYNE
DUBAI|DUBAY
DUCK|DUCKER|DUCKETT|DUCKIE|DUCKLING|DUCKSWORTH|DUCKWORTH|DUCKY
DUCT|DUCTWORK|DUCTZ
DUEL|DUELING|DUELL
DUFF|DUFFEE|DUFFER|DUFFEY|DUFFIE|DUFFIELD|DUFFIN|DUFFY
DUGA|DUGAN|DUGGAL|DUGGAN|DUGGAR|DUGGER|DUGGIN
DUMB|DUMBO|DUMBER|DUMBEST|DUM|DUMBY|DUMMY|DUMMER
DUMP|DUMPING|DUMPLIN|DUMPLING|DUMPSTER|DUMPTRUCK|DUMPTY
DUPLEX|DUPLEXE|DUPLICATE|DUPLICATING|DUPLICATION|DUPLICATOR
DUPRE|DUPREE|DUPREY
DUPUI|DUPUY
DURA|DURABLE|DURACLEAN
DUST|DUSTBUSTER|DUSTER|DUSTI|DUSTIN|DUSTING|DUSTLES|DUSTON|DUSTY
DUTCH|DUTCHER|DUTCHES|DUTCHMAN|DUTCHMEN|DUTCHTOWN|DUTHIE
DUTY|DUTIES
DUVAL|DUVALL
DWARF|DWARVES
DWELL|DWELLER|DWELLING|DWELLED
DYE|DYED|DYEING|DYER|DYES
DYKE|DYK|DYKEMA|DYKEMAN|DYKEN|DYKER|DYKMAN|DYKSTRA
DYNAMIC|DYN|DYNA|DYNAMI|DYNAMIK|DYNAMITE|DYNAMIX|DYNAMO|DYNATECH|DYNE|DYNMC|DYNMIC|DYNO|DYNOMITE
EARLY|EARLYBIRD
EARN|EARNED|EARNEST|EARNING
EARTH|EARTHBOUND|EARTHCARE|EARTHEN|EARTHLY|EARTHMAN|EARTHMOVER|EARTHMOVING|EARTHQUAKE|EARTHSCAPE|EARTHTONE|EARTHWISE|EARTHWORK|EARTHY|TERRESTRIAL
EASE|EASIER|EASY|EASYWAY|EAZE|EAZY
EAST|EASTCO|EASTCOAST|EASTE|EASTEND|EASTERLY|EASTERN|EASTRN|EASTWARD|EASTWEST
EAT|EATER|EATERIE|EATERY|EATIN|EATING|EATZ
ECCLESIASTICAL|ECCLE|ECCLESIA|ECCLESTON
ECOLOGY|ECO|ECOCLEAN|ECOLOGIC|ECOLOGICAL
ECONOMY|ECON|ECONO|ECONOMETRIC|ECONOMIC|ECONOMICAL|ECONOMIST|ECN|ECNMC|ECNMIC|ECNOMIC|ECOSYSTEM
ECSTASY|ECSTATIC
ECUADOR|ECUA|ECUADORIAN|ECUATORIANA|ECUATORIANO
ECCUMENICAL|ECUMENICAL|ECCUMNCAL
EDGE|EDGER|EDGING
EDIFICE|EDIFY
EDIT|EDITING|EDITION|EDITOR|EDITORIAL
EDUCATE|EDUC|EDUCA|EDUCACION|EDUCARE|EDUCAT|EDCTOR|EDCATN|EDCATOR|EDCO|EDCTL|EDCTN|EDCTNAL|EDCTNL|EDUCATED|EDUCATI|EDUCATING|EDUCATIO|EDUCATION|EDUCATIONA|EDUCATIVO|EDUCATN|EDUCATNAL|EDUCATNL|EDUCATONAL|EDUCATOR|EDUCTN|EDUCTNL|EDUTAINMENT|EDUTECH|ELEARNING|EDUCTL|EDUCATIONAL
EFFECT|EFFCT|EFFECTIVE|EFFECTIVENESS|EFFEX|EFX
EFFICIENT|EFFICENT|EFFICIENCIE|EFFICIENCY
EFFORT|EFFORTLESS
EGYPT|EGYPTIAN
ELASTIC|ELASTOMER
ELDERLY|ELDERCARE|ELDRLY
ELECTRIC|ELCTRIC|ELCO|ELCT|ELCTRC|ELCTRCL|ELCTRLYSI|ELCTRNC|ELCTRNIC|ELCTRONIC|ELECTRICA|ELECTRICAL|ELEC|ELECTIC|ELECTICAL|ELECTONIC|ELECTR|ELECTRA|ELECTRCAL|ELECTRCL|ELECTRI|ELECTRIAL|ELECTRICIAL|ELECTRICIAN|ELECTRICITY|ELECTRICO|ELECTRNC|ELECTRNIC|ELECTRO|ELECTROLOGIST|ELECTROLOGY|ELECTROMECHANICAL|ELETRIC|ELETRICAL|ELETRONIC|LECTRIC|ELECTRONIC|ELECTRON|ELECTRONI|ELECTRONICA|ELECTRONIX|ELEK|ELEKTRA|TRONIC|TRONIX
ELECT|ELECTION
ELEGANT|ELEGANCE|ELEGANCIA|ELEGANTE|ELEGANTLY|ELEGANZA|ELGANCE|ELGANT|ELGNCE
ELEMENT|ELEM|ELEMENTAL|ELEMENTARY|ELEMENTRY|ELMNT|ELMNTARY
ELEVATE|ELEV8|ELEVATED|ELEVATING|ELEVATION|ELEVATOR
ELIMINATE|ELIM|ELIMINATION|ELIMINATOR
ELOQUENT|ELOQUENCE
EMBARK|EMBARQUE
EMBELLISH|EMBELLISHED|EMBELLISHMENT
EMBODY|EMBODIED
EMBRACE|EMBRACING
EMBROIDER|EMBROID|EMBROIDERED|EMBROIDERIE|EMBROIDERING|EMBROIDERY|EMBROIDME
EMBRY|EMBRYO
EMCEE|EMC
EMERGENCY|AMERGENCY|EMERGNCY|EMERGENCIE|EMRG|EMRGCY|EMRGNCY
EMERGENCE|EMERGENT|EMERGING
EMIGRANT|EMIG|EMIGH
EMINENT|EMINENCE
EMOTIONAL|EMOTION
EMPIRE|MPIRE|EMPIREGA|EMPIRICAL
EMPLOY|EMPL|EMPLO|EMPLOYE|EMPLOYED|EMPLOYEE|EMPLOYER|EMPLOYMENT|EMPLYEE|EMPLYER|EMPLYMENT|EMPLYMNT
EMPORIUM|EMPO|EMPORIA|EMPORIO|EMPRIUM
EMPOWER|EMPOWERED|EMPOWERING|EMPOWERMENT|EMPOWRMENT|EMPWERMENT|EMPWRMENT|EMPWRMNT|EMPYREAN
EMPRES|EMPRESA|EMPRESARIAL|EMPRESARIO
EMERALD|EMRALD
ENABLE|ENABLED|ENABLER|ENABLING
ENAMEL|ENAMELING
ENCHANCEMENT|ENCHANTE|ENCHANTED|ENCHANTING|ENCHANTMENT
ENCLAVE|ENCLOSED|ENCIRCLED|ENCLOSURE
ENCOURAGE|ENCOURAGEMENT|ENCOURAGING
ENDEAVOR|ENDEAVOUR
ENDER|ENDING|ENDLES|ENDZ
ENDO|ENDOCRINE|ENDOCRINOLOGY|ENDODONTIC|ENDOSCOPIC|ENDOSCOPY|ENDOVASCULAR
ENDOW|ENDOWMENT|ENDWMENT
ENDURE|ENDURANCE|ENDURA|ENDURING|ENDURO
ENERGY|ENER|ENERG|ENERGETIC|ENERGIA|ENERGIE|ENERGIZE|ENERGIZED|ENERGIZER|ENRGY|ENTERGY
ENFORCE|ENFORCEMENT|ENFORCER|ENFRCEMENT|ENFRCMENT|ENFRCMNT
ENGAGE|ENGAGED|ENGAGEMENT|ENGAGING
ENGINE|ENGI|ENGIN|ENGINEE|ENGINEER|ENGINEERED|ENGINEERI|ENGINEERIN|ENGINEERING|ENGINERING|ENGINRED|ENGINRING|ENGNER|ENGNEER|ENGNR|ENGNRED|ENGNRING|ENGNRNG|ENGR|ENGRG|ENGRNG|TURBINE|TURBO
ENGLAND|ENGL|ENGLANDER|ENGLISH|ENGLND
ENGRAVE|ENGRAVED|ENGRAVER|ENGRAVING|ENGRV
ENHANCE|ENH|ENHANCED|ENHANCEMENT|ENHANCER|ENHANCING|ENHNCEMENT|ENHNCMENT|ENHNCMNT
ENLIGHT|ENLIGHTEN|ENLIGHTENED|ENLIGHTENING|ENLIGHTENMENT|ENLIGHTMENT
ENRICH|ENRCHMENT|ENRCHMNT|ENRICHED|ENRICHING|ENRICHMENT|ENRICHMNT
ENROLLED|ENROLLMENT
ENTERPRISE|ENTEPRISE|ENTERP|ENTERPIRSE|ENTERPISE|ENTERPR|ENTERPRI|ENTERPRICE|ENTERPRIE|ENTERPRIESE|ENTERPRISELLC|ENTERPRISER|ENTERPRISESINC|ENTERPRISESLLC|ENTERPRISING|ENTERPRSE|ENTERRISE|ENERPRISE|ENETERPRISE|ENTERRPISE|ENTPR|ENTPRISE|ENTREPRISE|ENTRPR|ENTRPRISE|ENTRPRS|ENTRPRSE|ENTRP|ENTERPRIZE
ENTERTAIN|ENTERT|ENTERTA|ENTERTAI|ENTERTAIMENT|ENTERTAINER|ENTERTAINING|ENTERTAINM|ENTERTAINME|ENTERTAINMEN|ENTERTAINMENT|ENTERTAINMNT|ENTERTNMENT|ENTERTNMNT|ENTRMT|ENTRTAINMENT|ENTRTN|ENTRTNMENT|ENTRTNMNT|ENTERAINMENT
ENTITY|ENTITIE
ENTRY|ENTRANCE|ENTRADA|ENTER
ENTRE|ENTREE
ENTREPRENEUR|ENTREPRENEURIAL|ENTREPRENEURSHIP|ENTREPRENUER
ENTRUST|ENTRUSTED
ENVIRONMENT|ENVIROMENT|ENVIO|ENVIORMENTAL|ENVIORNMENTAL|ENVIOU|ENVIR|ENVIRNMENTAL|ENVIRNMNTAL|ENVIROCARE|ENVIROCLEAN|ENVIROMENTAL|ENVIRON|ENVIRONM|ENVIRONME|ENVIRONMEN|ENVIRONMENTA|ENVIRONMENTALLY|ENVIRONMNTL|ENVIROSAFE|ENVIROTECH|ENVMT|ENVMTL|ENVRMNTAL|ENVRNMENTAL|ENVRNMNT|ENVRNMNTAL|ENVRNMNTL|ENVRONMENTAL|ENVIRO|ENVIRONMENTAL
ENVISAGE|ENVISION
EPICURE|EPICUREAN
EPIDEMIC|EPIDEMIOLOGY
EPISCOPAL|EPISCPAL|EPSCPAL|EPSCPL
EPSILON|EPSLON
EQUAL|EQUALITY|EQUALIZER
EQUESTRIAN|EQUEST|EQUESTRAIN|EQESTRIAN|EQINE|EQUINE|EQSTRIAN
EQUIPMENT|EQUIPM|EQUIPME|EQUIPMEN|EQUIPMNT|EQUIPO|EQUIPPED|EQUIPPING|EQUIPT|EQUIPTMENT|EQP|EQPMNT|EQPT|EQUIP
EQUITY|EQITY|EQUIT|EQUITA|EQUITABLE|EQUITIE|EQTY
ERASE|ERADICATION|ERASER
ERECT|ERECTING|ERECTION|ERECTOR
ERGONOMIC|ERG|ERGO|ERGON
EROTIC|EROTICA
ESPECIALLY|ESPE|ESPECIAL
ESPRESSO|ESPRES
ESSENTIAL|ESSE|ESSEN|ESSENCE|ESSENTIA|ESSENTIALLY|ESSNTIAL|SCENCE
ESTABLISHED|EST|ESTA|ESTAB|ESTABLISHMENT|ETB
ESTATE|ESTAT
ESTHETIC|ESTHETICIAN|ESTHETIQUE
ESTIMATE|ESTI|ESTIMATING|ESTIMATOR
ETCETERA|ETAL|ETC
ETCH|ETCHED|ETCHING
ETERNAL|ETERNA|ETERNALLY|ETERNITY|ETERNO
ETHIC|ETHICAL
ETHIOPIA|ETHIO|ETHIOPIAN
EUROPE|EROPEAN|EURO|EUROAMERICAN|EUROCAR|EUROPEAN|ERP|ERPEAN|EUR|EURASIA|EURASIAN|EURE
EVALUATION|EVAL|EVALUATOR|EVLATION|EVLTION|EVLUATION
EVANGELIC|EVANG|EVANGEL|EVANGELI|EVANGELIA|EVANGELICA|EVANGELICAL|EVANGELICO|EVANGELINA|EVANGELINE|EVANGELIO|EVANGELIQUE|EVANGELISM|EVANGELIST|EVANGELISTA|EVANGELISTIC|EVANGELISTICO|EVANGELIZATION|EVANGELO|EVANGLCAL|EVNGELISTIC|EVNGLCL|EVNGLICA|EVNGLISM|EVNGLISTIC|EVNGLSTC|EVNGLSTIC
EVENT|EVENTFUL|EVENTIDE|EVENTING|EVENTO|EVENTU|EVNT
EVERLAST|EVERLASTING|EVERLSTING
EVERY|EVERTHING|EVERYBODY|EVERYDAY|EVERYONE|EVERYTHING|EVERYWHERE|EVRYTHING
EVOLUTION|EVOL|EVOLA|EVOLUTIONARY|EVOLV|EVOLVE|EVOLVED|EVOLVING
EVERGREEN|EVRGRN
EXACT|EXACTA|EXACTLY|XACT
EXALT|EXALTED
EXAM|EXAMINATION|EXAMINER|EXAMINING
EXCALIBER|EXCALIBUR
EXCAVATE|EXCAV|EXCAVA|EXCAVAT|EXCAVATI|EXCAVATIN|EXCAVATING|EXCAVATION|EXCAVATOR|EXCAVTG|EXCVTG
EXCEL|EXCEED|EXCEEDING|EXCELL|EXCELLANCE|EXCELLE|EXCELLENCE|EXCELLENT|EXCELLING|EXCELLNCE|EXCELLO|EXCELSIOR|EXCEPTION|XLNT|EXCEPTIONAL|EXCEPTNAL|EXEL|XCEL|XCELL|XCELLENCE|XCELLENT|XCEPTIONAl|XCEED|XCESS|EXCESSIVE|EXCES|EXCLLENCE|EXCLLNCE
EXCHANGE|EXCH|EXCHA|EXCHAN|EXCHANG|EXCHANGER|EXCHNGE|XCHANGE
EXCITE|EXCITEMENT|EXCITING
EXCLUSIVE|EXCLSVE|EXCLUSIVELY|XCLUSIVE
EXECUTIVE|EXCTIVE|EXCTVE|EXECUTONE|EXECUTOR|EXE|EXEC|EXECU|EXECUTION|EXCUTIVE|EXETER
EXEMPLARY|EXEMPLAR
EXEMPT|EXEMPTION
EXHALE|EXHAUST
EXHIBIT|EXHIBITION|EXHIBITOR
EXIST|EXISTENCE
EXIT|EXITO
EXOTIC|EXOTICA|EXTIC|XOTIC|XTC
EXPAND|EXP|EXPANDED|EXPANDING|EXPANSION
EXPECT|EXPECTATION
EXPEDIA|EXPEDIENT
EXPEDITE|EXPEDITED|EXPEDITER|EXPEDITING|EXPEDITION|EXPEDITOR
EXPERIENCE|EXPER|EXPERIENCED|EXPERIENTIAL|EXPERIMENT|EXPERIMENTAL|EXPERT|EXPERTISE|EXPRNCE|EXPRT|XPERIENCE|XPERT
EXPLORE|EXPLORATION|EXPLORATORY|EXPLORER|EXPLORING|EXPLRATION|EXPLRTION
EXPLOSION|EXPLOSIVE|XPLOSION
EXPONENT|EXPONENTIAL
EXPORT|EXPOR|EXPORTER|EXPORTIMPORT|EXPORTING|XPORT
EXPO|EXPOSITION|EXPOSE|EXPOSED|EXPOSITO|EXPOSURE|XPOSURE|XPO
EXPRESSION|EXPR|EXPRE|EXPRES|EXPRESSED|EXPRESSIVE|EXPRESSLY|EXPRESSO|EXPRESSON|EXPRS|EXPRSSION|EXPRSSON|XPRESS|XPRES|XPRESSION
EXQUISITE|EXQUISITELY|XQUISITE
EXTEND|EXT|EXTENDED|EXTENDER|EXTENDING|EXTENSION|EXTENSIVE|EXTENTION|EXTNDED|XTENSION
EXTERIOR|EXTER|EXTERNAL|EXTROR|EXTRIOR|XTERIOR
EXTERMINATING|EXTERMINATION|EXTERMINATOR|TERMITE
EXTINGUISHER|EXTG
EXTRA|XTRA
EXTRACT|EXTRACTION|EXTRACTOR
EXTRAORDINARY|EXTRAORDINAIRE|XTRAORDINARY
EXTRAVAGANT|EXTRAVAGANZA
EXTREME|EXTREMELY|XTREAM|XTREEM|XTREME
EXTRUDED|EXTRUSION
EXXON|EXXONMOBIL
EYE|EYEBALL|EYEBROW|EYECARE|EYED|EYEGLAS|EYEGLASSE|EYELAND|EYELASH|EYELASHE|EYER|EYEWARE|EYEWEAR|EYEWORK|EYEZ
FABRIC|FABRI|FABRICA|FABRICARE
FABRICATED|FABRICAT|FABRICATI|FABRICATING|FABRICATIO|FABRICATION|FABRICATOR|FBR|FBRCATION|FBRCTION|FBRICATION|FBRICATOR|FBT
FABULOUSLY|FABULOU
FACE|FACADE|FACED|FACELIFT|FACET|FACEY|FACING
FACIAL|FACI|FCIAL
FACILITY|FACIL|FACILI|FACILIT|FACILITATION|FACILITATOR|FACILITIE|FACILTY|FCLITIE|FCILITIE|FCILTY|FCLTIE|FCLTY
FACT|FACTION|FACTO|FACTOR|FACTORING
FACTORY|FACTORIE|FCTRY
FADE|FADED|FADER
FAIL|FAILING|FAILSAFE|FAILURE
FAIR|FAIRE
FAIRY|FAIRIE|FAIREY|FAERIE|FAIRYLAND|FAIRYTALE
FAITH|FAIT|FAITHBASED|FAITHFUL|FAITHFULLY|FAITHWORK
FALCON|FALCONER
FALL|FALLEN|FALLIN|FALLING|FELL|FELLER|FELLING
FAMILY|FAMI|FAMIGLIA|FAMIL|FAMILIA|FAMILIAR|FAMILLE|FAMLY|FMLIE|FMILIE|FMILY|KINFOLK|KIN|FAMILIE|FAM|FMLY
FAMOUS|FAMOSA|FAMOU
FAN|FANATIC|FANDOM|FANNIN|FANNING
FANCY|FANCI|FANCIE|FANCIER|FANCIFUL
FANTASY|FANTASEA|FANTASIA|FANTASIE|FANTASTIC|FUNTASTIC|TASTIC
FARE|FAREED|FAREWELL
FARM|FARMER|FARMHOUSE|FARMING|FARMWORKER
FASHION|FASHIO|FASHIONABLE|FASHIONABLY|FASHIONED|FASHIONISTA|FASHIONZ|FASHN|FASHON|FASION|FSHION|FSHN|FSHON
FAST|FASTER|FASTEST
FASTENER|FASTENING|FASTNER
FATHER|FATH|FATHERHOOD|FTHER
FAVE|FAVER|FAVERO|FAVOR|FAVORED|FAVORITA|FAVORITE|FAVOUR
FEAR|FEARING|FEARLES
FEATHER|FEATHERED|FEATHERLITE
FEATURE|FEATURED|FEATURING
FEDERAL|FDRAL|FEDERACION|FDRATION|FDRL|FDRTION|FDRTN|FDTN|FDERAL|FDERATION|FEDERATED|FEDERATION|FEDRL|FEDRTN
FEED|FEEDBACK|FEEDER|FEEDING|FEEDLOT|FEEDYARD
FEEL|FEELGOOD|FEELIN|FEELING
FEIST|FEISTY
FELLOW|FELLO|FELLOWSH|FELLOWSHI|FELLOWSHIP|FELLOWSHP|FELLWSHP|FLLOWSHIP|FLLWSHIP|FLLWSHP|FLWSHP
FELON|FELONY
FEMALE|FEMINA|FEMININE|FEMINIST
FENCE|FENCER|FENCING|FNCE|FNCING
FERTILE|FERTILITY|FERTILIZATION|FERTILIZER|FERTILIZING
FEST|FESTA|FESTIVA|FESTIVAL|FESTIVE|FSTIVAL|FSTVAL
FETCH|FETCHING
FIBER|FIBR|FIBERGLAS|FIBERLINK|FIBEROPTIC|FIBERTECH|FIBRE|FIBRENEW|FIBRGL
FIDDLE|FIDDLEHEAD|FIDDLER|FIDLER
FIDELITY|FIDEL|FIDELCO|FIDELI|FIDELTY
FIDUCIARY|FIDUCIA|FIDUCIARIE
FIELD|FIELDER|FIELDHOUSE|FIELDING|FIELDSTONE
FIFE|FIFER
FIGHT|FGHTER|FGHTING|FIGHTER|FIGHTING|FOUGHT
FIGURE|FIGURA|FIGURINE|FIGMENT|FIGUEIREDO|FIGUEREDO|FIGUEROA
FILAMENT|FILAM
FILE|FILED|FILER|FILING
FILIPINO|FILIPINA|FILIPINOAMERICAN|FILIPPONE
FILL|FILLED|FILLER|FILLIN|FILLING
FILM|FILMING|FILMMAKER|FILMWORK|FILMZ|FLIX
FINAL|FINALE|FINALLY
FINANCE|FINAN|FINANACIAL|FINANC|FINANCAL|FIANCIAL|FINANCI|FINANCIA|FINANCIAL|FINANCIALLY|FINANCIER|FINANCIERA|FINANCING|FINANCL|FINANICAL|FINACIAL|FISCAL|FNANCIAL|FNNCIAL|FNNCL|FNANCL|FNCL|FNCTNAL
FIND|FINDER|FINDING
FINE|FINELY|FINER|FINERY|FINESSE|FINEST|FNEST
FINISH|FINISHE|FINISHED|FINISHER|FINISHING|FINISHLINE|FNISH|FNSHE|FNSHG
FIRE|FIER|FIERO|FIERRO|FIERY|FIREBALL|FIRELIGHT|FIREPLACE|FIRESIDE|FIRESTARTER|FIREWORK|FIRING|FLAME|FLAMING|FLAMIN
FIREFIGHTER|FIREFIGHTING|FIREHOUSE|FIRESTOP|FIRESTOPPING|FREFIGHTER|FRFGHTER|FRFIGHTER|FRMAN|FRMEN
FIREFLY|FIREFLIE
FIREPROOF|FIREPROOFING
FIREWOOD|FIREWD|FIREWEED
FISH|FISHBONE|FISHBOWL|FISHER|FISHERIE|FISHERMAN|FISHERMEN|FISHERY|FISHIN|FISHING|FISHKILL|FISHN|FISHNG|FISHY|FLYFISHER|FLYFISHING|FSHING|FSHNG|TROUT
FITH|FITHIAN
FIT|FITTED|FITTER|FITTING|FITNES|FITN|FITNE|FITNS|FITTNES|FTNE|FTNS
FIX|FIXALL|FIXATION|FIXE|FIXED|FIXER|FIXIN|FIXING|FIXIT|FIXX|FIXTURE
FLAG|FLAGER|FLAGG|FLAGGING|FLAGLER|FLAGPOLE|FLAGSHIP|FLAGSTAFF|FLAGSTONE
FLASH|FLASHBACK|FLASHER|FLASHING|FLASHLIGHT|FLASHPOINT|FLASHY
FLAT|FLATBED|FLATBREAD|FLATBUSH|FLATEN|FLATHEAD|FLATIRON|FLATWOOD|FLATLAND|FLATLANDER|FLATWORK
FLAVOR|FLAVIO|FLAVORED|FLAVOUR
FLEA|FLEAMARKET|FLEE
FLEET|FLEETING
FLEX|FLEXI|FLEXIBLE|FLEXO|FLEXX
FL|FLORIDA|FLORIAN|FLORIDAINC|FLORIDIAN|FLRIDA|INCFLORIDA
FLIP|FLIPPED|FLIPPEN|FLIPPER|FLIPPIN|FLIPPING|FLIPSIDE
FLIRT|FLIRTY
FLOAT|FLOATING|FLOTATION|FLOTILLA
FLOOR|FLOORCARE|FLOORCOVERING|FLOORED|FLOORI|FLOORIN|FLOORING|FLOORZ|FLORING|FLRCVG|FLRG
FLOW|FLOWBACK|FLOWING
FLOWER|FLORIST|FLORISTERIA|FLOWERING|FLOWERLAND|FLOWERY|FLRAL|FLRL|FLRNG|FLRST|FLWER|FLWR|FLOUR|FLOURISH|FLOURISHING|FLOURTOWN
FLUENT|FLUENCY
FLUFF|FLUFFY
FLURRY|FLURY
FLUSH|FLUSHING
FLY|FLGHT|FLITE|FLIER|FLIGHT|FLIGHTLINE|FLYBOARD|FLYBOY|FLYER|FLYIN|FLYING|FLYTE|FLYWAY|FLYWHEEL
FOCAL|FOCALPOINT|FOCUSED|FOCU
FOLD|FOLDER|FOLDING|FOLDED
FOLK|FOLKLORE|FOLKLORICO
FOLLOW|FOLLOWED|FOLLOWER|FOLLOWING
FOOD|FOODBANK|FOODIE|FOODLAND|FOODLINER|FOODMART|FOODSERVICE|FOODSTORE|FOODTOWN|FOODWORK
FOOL|FOOLISH
FOOT|FOOTACTION|FOOTAGE|FOOTB|FOOTBAL|FOOTBALL|FOOTBLL|FOOTCARE|FOOTE|FOOTER|FOOTHILL|FOOTHLL|FOOTING|FOOTLOOSE|FOOTMAN|FOOTPRINT|FOOTSTEP|FOOTWARE|FOOTWEAR|FOOTWORK|FOTBALL|FTBALL|FTBLL|FTWR|FUTBOL
FORCE|FRCE|FORCED
FORECAST|FORECASTING
FORECLOSURE|FORCLOSURE|FRCLSURE|FORECLOSE
FORGE|FORGED
FORGIVE|FORGIVEN|FORGIVENES
FORK|FORKED|FORKLIFT
FORM|FORMATION|FORMAT|FORMED|FORMER|FORMERLY|FORMING|FORMWORK
FORMAL|FORMALWEAR
FORMULA|FORMULATION
FORT|FORTRES
FORTUNE|FORTUNATE|FORTUNA|FORTUNATO
FORUM|FORU
FORWARD|FORWARDER|FORWARDING|FRWARD|FWD|FWDG
FOSTER|FOSTERING|FSTER|FSTR
FOUND|FOUNDA|FOUNDAT|FOUNDATI|FOUNDATIO|FOUNDATION|FOUNDATIONAL|FOUNDATIONINC|FOUNDATN|FOUNDATON|FND|FNDATN|FNDING|FNDN|FNDT|FNDTN|FNDTON|FOUNDING|FOUNDTION|FOUNDTN|FUNDACION|FUNDATION|FONDATION|FOUDATION|FOUN|FOUNDRY|FNDRY|FOUNDER|FOUNDRIE|FNDTION|FNDATION
FOUNT|FOUNTAIN|FOUNTAINE|FOUNTAINHEAD|FOUNTAINVIEW
FRACTURE|FRAC|FRACK|FRACTIONAL|FRACTURED
FRAGRANT|FRAGRANCE|FRAGANCE
FRAME|FRAMED|FRAMELES|FRAMER|FRAMERY|FRAMEWORK|FRAMIN|FRAMING|FRMNG|FRMR
FRANCHISE|FRANCHI|FRANCHISEE|FRANCHISING|FRANCHISOR|FRNCHISE
FRATERNAL|FRATERNIDAD|FRATERNITY|FRATNRL
FREAK|FREAKY
FRECKLE|FRECKLED
FRED|FRDERICK|FRDRICK|FREDA|FREDDA|FREDDIE|FREDDY|FREDE|FREDERIC|FREDERICA|FREDERICK|FREDERICO|FREDETTE|FREDI|FREDK|FREDO|FREDRIC|FREDRICH|FREDRICK|FREDRICKSON|FREDY
FREE|FREED|FRDOM|FREEDOM|FREDOM|FREEFORM|FREEHAND|FREEL|FREELANCE|FREELANCER|FREELANCING|FREELY
FREEZE|FREEZ|FREEZER|FREEZING|FRIEZE|FRIGID|FRIGIDAIRE|FROST|FROSTBITE|FROSTED|FROSTING|FROSTPROOF|FROSTY|FROZEN
FREIGHT|FREIGHTER|FREIGHTLINE|FREIGHTLINER|FREIGHTWAY|FRIEGHT
FRENCH|FRENCHIE|FRENCHMAN|FRENCHTOWN|FRENCHY|FRANCE|FRNC|FRNCE|FRNCH
FREQUENT|FREQUENCY
FRESH|FRESHENER|FRESHER|FRESHLY|FRSH
FRIDGE|REFRIGERATOR|REFRI|REFRIDGERATION|REFIGERATION|REFRIG|REFRIGE|REFRIGERANT|REFRIGERAT|REFRIGERATED|REFRIGERATI|REFRIGERATING|REFRIGERATIO|REFRIGERATION|RFRG|RFRGN
FRIEND|FRIENDLY|FRIENDSHIP|FRIENDZ|FRND|FRNDLY|FRNDSHIP
FRISBEE|FRISBY|FRISBIE
FRANKLIN|FRNKLIN
FROG|FROGG|FROGGIE|FROGGY|FROGTOWN
FRONT|FRNTR|FRONTAGE|FRONTERA|FRONTIER|FRONTLINE|FRONTR|FRONTRUNNER
FRUIT|FRUITA|FRUITFUL|FRUITION|FRUITLAND|FRUITPORT|FRUITVALE|FRUITVILLE|FRUITY|FRUTTI
FRY|FRIER|FRIES|FRYAR|FRYE|FRYER|FRYMAN
FUEL|FUELED|FUELING
FULFILL|FULFILLED|FULFILLING|FULFILLMENT|FULLFILLMENT
FULL|FULLY|FULLNES|FULLHOUSE
FUNCTION|FUNCTIONAL|FUNCTNAL
FUND|FNDNG|FNDRSING|FUNDED|FUNDER|FUNDAMENTAL|FUNDERSCLUB|FUNDI|FUNDING|FUNDRAISER|FUNDRAISING
FUNERAL|FNRL|FUNERARIA|FUNRL
FUNK|FUNKY
FURNITURE|FTURNISH|FTRE|FTURE|FURNISHED|FURNISHER|FURNISHING|FURNIT|FURNITU|FURNITUR|FURNTR|FURNI|FURNIS|FUNITURE|RECLINER
FUR|FURR|FURRER|FURRIER|FURRY
FUSE|FUSED|FUSING|FUSION|FUSON|FUSZ|FUZION|FUZE
FUTURE|FUTURA|FUTURISTIC|FUTURITY|FUTURO
FUZZ|FUZZY
GA|GEORGIA
GAIN|GAINER|GAINING|GAINZ|GAINED
GALLANT|GALANT|GALAHAD|GALANTE
GALAXY|GALAX|GALAXIE
GALLERY|GALERY|GALERIA|GALERIE|GALLERIA|GALLERIE|GLLERY|GLLRY
GALLOP|GALLOPING
GAMBLE|GAMBLER|GAMBLIN|GAMBLING
GAME|GAMEBIRD|GAMECOCK|GAMEDAY|GAMER|GAMEROOM|GAMERZ|GAMESTOP|GAMETIME|GAMEZ|GAMING|GMING
GANG|GANGSTER
GARDEN|GARDENA|GARDENDALE|GARDENER|GARDENIA|GARDENSCAPE|GARDENVIEW|GARDINER|GARDN|GARDNER|GDNR|GRDEN|GRDN|GRDON|GRNDING|GROUNDSKEEPER|GROUNDSKEEPING|GARDENING
GAS|GASAWAY|GASLAMP|GASLIGHT|GASOLINE|GASSTATION
GASTRO|GASTROENTEROLOGY|GASTROINTESTINAL|GSTRNTRLOGY|GSTROENTEROLOGY|TUMMY
GATE|GATED|GATEHOUSE|GATEKEEPER|GATEWAY|GTW|GTWY
GATHER|GATH|GATHERED|GATHERING|GATHING
GAZE|GAZAWAY|GAZEBO
GEAR|GEARBOX|GEARED|GEARHEAD|GEARING
GEM|GEMOLOGICAL|GEMOLOGIST|GEMSTAR|GEMSTONE|GEMZ
GENDER|GENDREAU
GENE|GENEALOGICAL|GENEALOGY|GENETIC
GENERATION|GENERATIONAL|GENER|GENERA|GENERACION|GENERTION|GNRTION|GNRATION|GNERATION|GENERATE|GENERATING|GENERATOR
GENERAL|GENERALE|GENRAL|GENERI|GENERIC|GNRL
GENEROSITY|GENEROU
GENTLE|GENTILE|GENTILLY|GENTLEMAN|GENTLEMEN|GENTLY|GENTRY|GENTZ
GENUINE|GENU
GEOGRAPHY|GEOGRAPHIC
GEOLOGIC|GEOLOGICAL|GEOLOGIST|GEOLOGY|GEOPHYSIC|GEOPHYSICAL|GEOSCIENCE|GEOSERVICE|GEOTECH|GEOTECHNICAL|GEOTHERMAL|TECTONIC
GEOMETRY|GEOMETRIC|GEOSPATIAL
GERMAN|GERMANAMERICAN|GERMANIA|GERMANO|GERMANTOWN|GERMANY|GRMAN|DEUTSCHE|DEUTSCH
GET|GETTING|GETAWAY
GHANA|GHANAIAN
GIFT|GIFTED|GIFTING|GIFTSHOP|GIFTWARE
GIGABYTE|GIG|GIGA
GIGANTIC|GIGANTE|GIANT
GINGER|GINGERBREAD
GIRL|GIRLFRIEND|GIRLIE|GIRLY|GIRLZ
GIVE|GIVEAWAY|GIVEN|GIVER|GIVING
GLACIER|GLACIAL
GLAD|GLADDEN|GLADDING
GLAM|GLAMOR|GLAMOROU|GLAMOUR
GLASS|GLASCO|GLASSBLOWING|GLASSWARE|GLASSWORK|GLASSY|GLAZE|GLAZED|GLAZER|GLAZIER|GLAZING
GLEAM|GLEAMING
GLIDE|GLIDER|GLIDING
GLIMPSE|GLIMMER
GLITTER|GLITZ|GLITZY
GLOBAL|GLOB|GLOBA|GLOBALLY|GLOBALNET|GLOBALTECH|GLOBE|GLOBEL|GLOBETROTTER|GLOBEX|GLOBL
GLORY|GLORI|GLORIA|GLORIE|GLORIFIED|GLORIOSO|GLORIOU|GLORYLAND
GLUTEN|GLUTENFREE
GOBBLE|GOBBLER
GOD|GODDESS|GODDESSE|GODFATHER|GODLY|GODMOTHER|GODSPEED|GODZ
GOLD|GLD|GLDEN|GLDN|GOLDEN|GOLDMINE|GOLDN
GOLF|GOLFER|GOLFING|GOLFO|GOLFSIDE|GOLFVIEW
GOURMET|GOURMAND|GOURMENT|GRMET
GOVERNMENT|GOVERMENT|GOVERN|GOVERNANCE|GOVERNING|GOVERNMENTAL|GOVERNOR|GOUVERNEUR|GOVT|GVRNMENT|GVERNMENT
GRAB|GRABBER
GRACE|GRACEFUL|GRACEFULLY
GRADE|GRADER|GRADIENT|GRADING
GRADUATE|GRADUATION
GRAFFITI|GRAFFEO
GRAMMAR|GRAMMER
GRANDMA|GRANDKID|GRANDMOTHER|GRAMMIE|GRAMMY|GRAMP|GRAMPA|GRANDFATHER|GRANDCHILDREN|GRANDPA|GRANDPARENT|GRANDSON|GRANNI|GRANNIE|GRANNY
GRANT|GRANTED|GRANTOR|GRNT
GRAPE|GRAPEVINE
GRAPH|GRAPHI|GRAPHIC|GRAPHICAL|GRAPHIX|GRAPHX|GRAPIC|GRPHC|GRPHIC|GRAFFIX|GRAFIC|GRAFIK|GRAFIX
GRAPPLER|GRAPPLING
GRAZE|GRAZING
GREASE|GREASER|GREASY
GREAT|GR8|GREATER|GREATEST|GREATNES|GREATR
GREECE|GREEK
GRILL|GRILLE|GRILLED|GRILLER|GRILLI|GRILLIN|GRILLING|GRILLZ
GRIND|GRINDER|GRINDING|GRINDSTONE|GRINDZ
GRIP|GRIPPER
GRIT|GRITTY|GRITZ
GRIZZLE|GRIZZLEY|GRIZZLIE|GRIZZLY
GROOM|GRMING|GRMNG|GROOMED|GROOMER|GROOMERY|GROOMING
GROOVE|GROOVIN|GROOVY|GROPP
GROUND|GROUNDED|GROUNDHOG|GROUNDING|GROUNDUP|GROUNDWATER|GROUNDWORK
GROUP|GROUPINC|GROUPLLC|GROUPO|GRP
GROUT|GROUTING
GROW|GROWER|GROWING|GROWN|GROWTH|GRW|GRWER|GRWTH
GROVE|GRVE
GUARANTEE|GUARANTEED|GUARANTOR|GUARANTY|GUAR|GUARANTIED
GUARD|GAURD|GAURDIAN|GUARDADO|GUARDIA|GUARDIAN|GUARDIANSHIP|GUARDING|GUARDIOLA|GUARDRAIL|GUARDSMAN|GRDIAN|GRDING
GUEST|GUESTHOUSE
GUIDE|GUIDANCE|GUIDED|GUIDELINE|GUIDER|GUIDING
GULF|GULFCOAST|GULFGATE|GULFPORT|GULFSHORE|GULFSIDE|GULFSTAR|GULFSTREAM|GULFTEX|GULFVIEW|GULFWAY
GYM|GYMBOREE|GYMNASIUM|GYMNAST|GYMNASTIC|GYMNSTC|GYMNSTIC
GYN|GYNCLOGY|GYNCOLOGY|GYNE|GYNECOLOGIC|GYNECOLOGICAL|GYNECOLOGY|OBGYN
GYPSY|GYPSIE
HABIT|HABILITATION|HABITAT|HABITATION|HBTAT
HACK|HACKER|HACKING
HAIR|HAIRBRAIDING|HAIRCARE|HAIRCUT|HAIRCUTTER|HAIRCUTTING|HAIRDESIGN|HAIRDRESSER|HAIRDRESSING|HAIRE|HAIREM|HAIRITAGE|HAIRLINE|HAIRPORT|HAIRSALON|HAIRSTON|HAIRSTYLE|HAIRSTYLING|HAIRSTYLIST|HAIRWAY|HAIRWORK|HAIRY|HAISLIP|BARBER|BARBERSHOP|BRBRSHOP|SALON|SOLON|SOLN
HAITI|HAITIAN|HAITIANAMERICAN|HAITIENNE|HTIAN
HALF|HALFTIME|HALFWAY
HAND|HANDBAG|HANDBALL|HANDBOOK|HANDCRAFT|HANDCRAFTED|HANDCRAFTER|HANDED|HANDFUL|HANDHELD|HANDWASH|HANDWORK|HANDWOVEN|HANDWRITING|HANDICRAFT|HANDIMAN|HANDIWORK|HANDLEY|HANDMADE|HANDMAN|HANDPAINTED|HANDPIECE|HANDPRINT|HANDRAIL|HANDSHAKE|HANDSOME|HANDY|HANDI|HANDYM|HANDYMA|HANDYMAN|HANDYMEN|HANDYWORK|HANDZ|HNDYMAN|HNDYMN|HANDMAID
HANDLE|HANDLEBAR|HANDLER|HANDLING
HANDICAP|HANDICAPPED
HANG|HANGAR|HANGER|HANGIN|HANGING|HANGMAN|HANGOUT|HANGOVER|HANGTOWN|HANGUP
HAPPEN|HAPPENING
HAPPY|HAPPI|HAPPIER|HAPPILY|HAPPINES|HAPPYLAND
HARBOR|HARBORAGE|HARBORSIDE|HARBORTOWN|HARBORVIEW|HARBOUR|HARBOURSIDE|HRBOR|HRBOUR
HARD|HARDEN|HARDER|HARDCASTLE|HARDCORE|HARDLY|HARDROCK|HARDSCAPE|HARDSCAPING|HARDSCRABBLE|HARDWARE|HARDWEAR|HARDWOOD|HARDY|HDWR|HRD|HRDWOOD
HARLEY|HARLEYDAVIDSON|HRLEY
HARMONY|HARMONIA|HARMONIC|HARMONICA|HARMONIE|HARMONIOU|HRMONY
HARP|HARPIST
HARVEST|HARVESTER|HARVESTING|HARVSTG|HRVEST
HAT|HABERDASHER|HABERDASHERY|HEADWEAR|HARDHAT
HATCH|HATCHER|HATCHERIE|HATCHERY
HAWK|HAWKER|HAWKEYE
HAZARD|HAZARDOU|HAZZARD
HAZEL|HAZELNUT|HAZELWOOD
HEAD|HEADED|HEADER|HEADHUNTER|HEADING|HEADY|HEADZ
HEADLINE|HEADLINER
HEADQUARTER|HDQTR|HEADQUATER
HEAL|HEALED|HEALER|HEALING|HEALNG|HEALT|HEALTCARE|HEALTH|HEALTHC|HEALTHCA|HEALTHCAR|HEALTHCLAIM|HEALTHFUL|HEALTHIER|HEALTHY|HEATH|HEATHCARE|HEATLH|HELTH|HLING|HLNG|HLR|HLTH|HLTHCR|HLTHCRE|HLTHY|HOMEHEALTH|TELEHEALTH|HLTHCARE|HEALTHCARE
HEART|HEARTY|CARDIAC|CARDIO|CARDIOLOGIST|CARDIOLOGY|CARDIOPULMONARY|CARDIOTHORACIC|CARDIOVASCULAR|CARDIVSCLAR|CRDIAC|CRDIOLGY|CRDIOVASCULAR|CRDLGY|CRDN|CRDOVASCULAR|CRDVSCLAR|CRDVSCULAR
HEAT|HEATED|HEATER|HEATI|HEATIN|HEATING|HEATNG|HVA|HVAC|HVACR|HVC
HEAVEN|HAVEN|HEAVENLY|HVEN
HEAVY|HEAVEY|HEAVYWEIGHT|HEFT|HEFTY
HEDGE|HEDGED|HEDGER|HEDGEROW|HEDGING
HEIR|HEIRES|HEIRLOOM
HELP|HELPDESK|HELPER|HELPFUL|HELPING|HELPLINE|HELPUSELL|HLP|HLPING|HLPNG
HEMATOLOGY|HEMATOLOGYONCOLOGY|HEMOPHILIA
HERB|HERBA|HERBAL|HERBALIFE|HERBALIST|HRBAL
HERMIT|HERMITAGE
HEX|HEXAGON
HI|HAWAII|HAWAI|HAWAIIAN|HAWAIIN
HIDE|HIDEAWAY|HIDEOUT|HIDEWAY
HIGH|HGH|HGHE|HGHER|HGHLAND|HGHLND|HGHT|HIGHEND|HIGHER|HIGHEST|HIGHLAND|HIGHLANDER|HIGHLIFE|HIGHLIGHT|HIGHLINE|HIGHLND|HIGHLY|HIGHMARK|HIGHNES|HIGHPOINT|HIGHPOINTE|HIGHRIDGE|HIGHRISE|HIGHSPEED|HIGHT|HIGHTECH|HIGHTOWER|HIGHVIEW|HIGHWATER|HIPOINT|HIRISE
HIKE|HIKER|HIKING
HILL|HILLSIDE|HILLTOP|HILLTOPPER|HILLY
HIP|HIPPIE|HIPPY|HIPSTER
HIRE|HIRD|HIRED|HIRING|HRING
HISPANIC|HISPANA|HISPANIOLA|HISPANO|HSPANIC|HSPNIC
HIST|HISTO|HISTOLOGY|HISTORCAL|HISTORIAN|HISTORIC|HISTORICAL|HISTORY|HSTORIC|HSTORICAL|HSTORY|HSTRCAL|HSTRCL|HSTRIC|HSTRICAL
HITCH|HITCHIN|HITCHING
HIT|HITTER|HITTING|HITZ
HOCKEY|HCKEY
HOIST|HOISTING
HOLD|HOLDER|HOLDG|HOLDI|HOLDIN|HLDG|HLDING|HLDNG|HOLDINGSLLC|HOLDNG|HOLDING|HOLDCO
HOLE|HOLEY|HOLY
HOLISTIC|HLISTIC|HLSTIC|WHOLISTIC
HOLIDAY|HLDAY|HOLLI|HOLLIDAY|HOLLIDAYSBURG
HOLLOW|HLLOW
HOLLY|HOLLYWOOD|HLLYWOOD|HLLY
HOLOGRAM|HOLOGRAPHIC
HOME|HOUSE|HACIENDA|HOUSEBOAT|HSNG|HOUSING|HSING
HOMEBUILDER|HOMEBUILDING
HOMECARE|HMCARE|HMECARE
HOMECRAFT|HOMECRAFTER
HOMELES|HMLES|HOMELESSNES
HOMEMADE|HMMADE
HOMEMAKER|HOMEMAKING
HOMEO|HMEO|HOMEOPATHIC|HOMEOPATHY
HOMEOWNER|HMEOW|HMEOWN|HMEOWNER|HMEOWNR|HOMEOW|HOMEOWN|HOMEOWNE|HOMEOWNERSHIP|HOMEOWNR|HMOWN|HMOWNER|HMOWNR|HMWNER|HMWNR|HOMEBUYER|HOUSEHOLD|HOUSEHOLDER
HONEST|HONESTLY|HONESTY
HONEY|HONEYBEE|HONEYCOMB|HONEYDEW|HONEYDO|HONEYMOON|HONEYSUCKLE
HONOR|HONORABLE|HONORARY|HONORE|HONORING|HONORIO|HONOUR
HOOF|HOOFBEAT
HOOK|HOOKED|HOOKER|HOOKUP
HOPE|HOPEFUL
HOP|HOPPER|HOPPIN|HOPPING|HOPPY|HOPSCOTCH
HORIZON|HORIZEN|HORIZION|HORIZONTAL|HORIZONTE|HRIZON|HRZN|HRZON
HORSE|HORSEBACK|HORSEFEATHER|HORSEHEAD|HORSELES|HORSEMAN|HORSEMANSHIP|HORSEMEN|HORSEPOWER|HORSESHOE|HORSESHOEING|HORSETOOTH
HORTICULTURE|HORTICULTURAL
HOSP|HOSPI|HOSPICE|HOSPIT|HOSPITA|HOSPITAL|HOSPITALIST|HOSPITALITIE|HOSPITALITY|HOSPITLITY|HOSPTIAL|HOSPTL|HSPICE|HSPITALITY|HSPTALITY|HSPTL|HSPTLITY
HOST|HOSTED|HOSTES|HOSTING
HOTEL|HOSTEL|HTEL|INN|MOTEL
HOT|HOTLINE|HOTROD|HOTSHOT|HOTSPOT|HOTSY|HOTTEST|HOTTIE|HOTWIRE|HOTZ
HOUSEKEEPER|HOUSEKEEPING|HOUSECLEANING|HOUSEWORK|HOUSEBOY|HUSEBY|HUSEKEEPING|HOUSEWIFE|HOUSEWIVE|INNKEEPER
HOVER|HOVERCRAFT
HOWL|HOWLIN|HOWLING
HUG|HUGGABLE|HUGGER|HUGGY
HUMAN|HMNITY|HMANITY|HUMANA|HUMANE|HUMANIST|HUMANISTIC|HUMANITARIAN|HUMANITIE|HUMANITY
HUMMER|HUMMING|HUMMINGBIRD
HUNGARY|HUNGARIAN
HUNGER|HUNGRY
HUNT|HNTER|HNTING|HUNTER|HUNTIN|HUNTING
HURRICANE|HURRICAN|HRRCANE
HUSBAND|HUSBANDRY
HUSK|HUSKER|HUSKEY|HUSKIE|HUSKY
HUSTLE|HUSTLER
HWY|HIGHWAY
HYDRAULIC|HYDRLIC
HYDRO|HYDROCARBON|HYDROELECTRIC|HYDROGEN|HYDROGRAPHIC|HYDROLIC|HYDROLOGIC|HYDROLOGY|HYDRONIC|HYDROPONIC|HYDROPOWER|HYDROSEED|HYDROSEEDING|HYDROSTATIC|HYDROTECH|HYDROTHERAPY
HYGIENE|HYGIENIC|HYGIENIST
HYPNO|HYPNOSI|HYPNOTHERAPIST|HYPNOTHERAPY|HYPNOTIC|HYPNOTIST
IA|IOWA|IOWAN
IBERIA|IBERIAN
ICE|ICEBERG|ICEBOX|ICECREAM|ICED|ICEE|ICEHOUSE|ICEMAN|ICEBURG
ICELAND|ICELANDIC
ICON|ICONIC
ID|IDAHO|IDAHOAN
IDEA|IDEAL|IDEALEASE|IDEATION
IDENTITY|IDENTIFICATION|IDEN|IDENTIFY|IDENTIFIER
IGNITE|IGNITED|IGNITING|IGNITION
IL|ILLINOIS
ILLUMINATE|ILLUMINA|ILLUMINATED|ILLUMINATI|ILLUMINATING|ILLUMINATION
ILLUSTRATE|ILLUSTRATED|ILLSTRATION|ILLSTRTION|ILLUSTRATION|ILLUSTRATOR|ILLUSTRIOU
IMAGE|IMAG|IMAGEMAKER|IMAGEN|IMAGENE|IMAGERY|IMAGEWORK|IMAGEZ|IMAGI|IMAGIN|IMAGINARIUM|IMAGINARY|IMAGINATION|IMAGINATIVE|IMAGINE|IMAGINED|IMAGINEERING|IMAGING|IMAGINING|REIMAGINE|REIMAGINED
IMMACULATE|IMMACLATE
IMMERSION|IMMERSIVE|IMMERSE
IMMIGRATE|IMMGRATION|IMMGRTION|IMMIGRANT|IMMIGRATION|INMIGRANTE
IMMOBILIZATION|IMMOBILIARE|IMMOBILIEN|INMOBILIARIA
IMMUNE|IMMUNIZATION|IMMUNO|IMMUNOLOGY
IMPACT|IMP|IMPAC|IMPACTING|IMPACTO
IMPAIR|IMPAIRED|IMPAIRMENT
IMPERIAL|IMPERIO|IMPERIUM
IMPLANT|IMPLANTOLOGY|IMPLNT
IMPLEMENT|IMPLEMENTATION
IMPORT|IMPORIUM|IMPO|IMPOR|IMPORTACIONE|IMPORTED|IMPORTER|IMPORTEXPORT|IMPORTING|IMPRT|IMPT|INPORT|IMPORTANT|IMPORTADORA
IMPRES|IMPRESSION|IMPRESSIVE|IMPRSSION|IMPRSSON
IMPRINT|IMPRINTED|IMPRINTING|IMPRENTA
IMPROVE|IMPRO|IMPROV|IMPORVEMENT|IMPROVED|IMPROVEM|IMPROVEME|IMPROVEMEN|IMPROVISATION|IMPROVISATIONAL|IMPROVISED|IMPROVEMNT|IMPROVER|IMPROVING|IMPROVMENT|IMPRV|IMPRVMNT|IMPRVMT|INPROVEMENT|IMPROVEMENT
IN|INDIANA
INCARNATION|INCARCERATED
INCLINE|INCLINED
INCLUDE|INCLUDED|INCLUDING|INCLUSION|INCLUSIVE
INCOME|INCOM|INCOMETAX
INCREASE|INCREASING
INCUBATION|INCUBATOR
INDEPENDENT|INDEP|INDEPE|INDEPEN|INDEPEND|INDEPENDANCE|INDEPENDANT|INDEPENDE|INDEPENDEN|INDEPENDENCE|INDEPENDIENTE|INDEPENDNT|INDEPNDENT|INDEPNDNCE|INDEPNDNT|INDPNDNCE|INDPNDNT
INDEX|INDEXING
INDIA|INDIALANTIC|INDIAN|INDO|INDOAMERICAN
INDIANAPOLI|INDY
INDIVIDUAL|INDIVID|INDIVIDU|INDIVIDUA|INDIVIDUALIZED|INDIVIDUALL|INDIVIDUALLY|INDV|INDVDALLY|INDVDLLY|INDVDUAL
INDONESIA|INDONESIAN
INDULGE|INDULGENCE|INDULGENT
INDUSTRY|INDUST|INDUSTIE|INDUSTIRE|INDUSTR|INDUSTRAIL|INDUSTRI|INDUSTRIA|INDUSTRIAL|INDUSTRIALE|INDUSTRIALIZATION|INDUSTRIE|INDUSTRIESINC|INDUSTRIOU|INDUSTRL|INDSTR|INDSTRIAL|INDSTRL|INDSTRY
INFANT|INFANTE|ENFANT|INFANTIL|INFNT
INFECTION|INFCTOU|INFECTIOU|INFECT|INFECTED
INFINITE|INFINI|INFINET|INFINIT|INFINITI|INFINITUM|INFINITY|INFINIUM
INFLATE|INFLATABLE|INFLATION
INFLUENCE|INFLUENCER|INFLUENTIAL
INFO|INFOCOM|INFOR|INFORM|INFORMA|INFORMAT|INFORMATI|INFORMATIC|INFORMATICA|INFORMATIO|INFORMATION|INFORMATIONAL|INFORMATIVE|INFORMED|INFORMER|INFORMTION
INFRASTRUCTURE|INFRSTRCTURE|INFRSTRUCTURE
INFUSE|INFUSED|INFUSION
INGENUITY|INGENIOU|INGENIUM
INHOME|INHOUSE
INIT|INITATIVE|INITIAL|INITIATIVE|INTIATIVE|INTTIVE
INJECT|INJECTION|INJECTOR
INJURY|INJRY|INJURED|INJURIE
INK|INKD|INKED|INKJET|INKLING|INKSTER|INKWELL|INKY|REINKING
INNER|INNERCITY|INNERSPACE|INNERVISION
INNOCENCE|INNOCENT
INNOVATE|INNOVATED|INNOVATING|INNOVATION|INNOVATIVE|INNOVATOR|INNOVTIVE|INNVATION|INNVATIVE|INNVTION|INNVTIVE|INNVTN|INNVTON|INOVATION|INOVATIVE
INQUIRY|INQUIRIE|INQ
INSANE|INSANITY
INSOMNIA|INSOMNIAC
INSPECT|INSPCTION|INSP|INSPCTN|INSPCTON|INSPE|INSPEC|INSPECTI|INSPECTING|INSPECTIO|INSPECTN|INSPECTOR|INSPECTION
INSPIRE|INSPIRA|INSPIRATION|INSPIRATIONAL|INSPIRED|INSPIRING|INSPIRIT|INSPRTION|INSPTN
INSTALL|INSTA|INSTAL|INSTALATION|INSTALLA|INSTALLAT|INSTALLATI|INSTALLATIO|INSTALLATION|INSTALLATN|INSTALLED|INSTALLER|INSTALLING|INSTALLMENT|INSTALLTION|INSTALLTN|INSTLLATION|INSTLLTION|INSTLLTN|INSTLLTON|INSTLTN
INSTINCT|INSTINCTIVE
INSTITUTE|INSTTUTE|INST|INSTIT|INSTITU|INSTITUE|INSTITUT|INSITUTE|INSTITUTION|INSTITUTIONAL|INSTITUTO|INSTL|INSTN|INSTNL
INSTRUCT|INSTR|INSTRCTION|INSTRCTN|INSTRCTNAL|INSTRU|INSTRUCTION|INSTRUCTIONAL|INSTRUCTOR
INSTRUMENT|INSTRUMENTAL|INSTRUMENTATION
INSUL|INSULATE|INSULATED|INSULATING|INSULATION|INSULATOR
INSURE|INSUR|INSURA|INSURACE|INSURAN|INSURANC|INSURANCE|INSR|INSRANCE|INSRNC|INSRNCE|INSU|INSUANCE|INSURED|INSURER|INSURING|INSURNACE|INSURNCE|INSUROR|REINSCH|REINSURANCE
INTEGRATE|INTEG|INTEGER|INTEGR|INTEGRA|INTEGRAL|INTEGRATED|INTEGRATING|INTEGRATION|INTEGRATIVE|INTEGRATOR|INTEGRI|INTEGRITA|INTEGRITY|INTEGRO|INTEGRTD|INTEGRTED|INTEGRTIVE|INTGRATED|INTGRATION|INTGRATIVE|INTGRTD|INTGRTED|INTGRTION|INTGRTIVE|INTGRITY|INTERGRATED|INTERGRATION|INTERGRATIVE|INTERGRITY
INTEL|INTELL|INTELLECT|INTELLECTUAL|INTELLGENT|INTELLI|INTELLIGENCE|INTELLIGENT|INTLLCTUAL|INTLLGENCE|INTLLGENT|INTLLGNCE|INTLLIGENCE
INTENSE|INTENSITY|INTENSIVE
INTENT|INTENTION|INTENTIONAL
INTERACT|INTERCTIVE|INTERACTION|INTERACTIVE|INTRACTIVE|INTRCTIVE
INTERAMERICA|INTERAMERICAN
INTERCEPT|INTERCESSION|INTERCESSOR|INTERCESSORY|INTERCEPTED|INTERCEPTION
INTERCITY|INTERCOASTAL|INTERCOUNTY|INTRACOASTAL|INTRASTATE|INTRSTATE
INTERCULTURAL|INTERDENOMINATIONAL|INTERDISCIPLINARY|INTERFAITH|INTERFITH|INTERGENERATIONAL|INTERGROUP|INTERCOM|INTERCOMMUNITY|INTRFITH
INTERCON|INTERCONNECT|INTERCONNECTION
INTEREST|INTERESTED|INTERESTING|INTREST|INTRST
INTERIOR|INTEROR|INTERI|INTERIO|INTERIORSCAPE|INTRIOR|INTROR
INTERLOCK|INTERLOCKING|INTERLOCHEN
INTERMEDIATE|INTERMED|INTERMEDIA|INTERMEDIARIE|INTERMEDIARY|INTERMNTAIN|INTRMDATE
INTERNAL|INTERNL|INTRNL
INTERNATIONAL|INTERNAT|INTERNATI|INERNATIONAL|INTERNATINAL|INTERNATIO|INTERNATION|INTERNATIONA|INTERNATIONALE|INTERNATIONALINC|INTERNATIONL|INTERNATL|INTERNATNL|INTERNATONAL|INTERNTNL|INTERNTONAL|INTEROCEAN|INTERNTIONAL|INTERNTL|INTERPACIFIC|INTERNACIONALE|INTERNAITONAL|INTENATIONAL|INTERGALACTIC|INTERANTIONAL|INTERCNTNNTAL|INTERCONTINENTAL|INTERGLOBAL|INTERMARKET|INTL|INTNL|INTRNAL|INTRNATIONAL|INTRNCNAL|INTRNTL|INTRNTNAL|INTRNTNL|INTRNTONAL|INTRNTIONAL|TRANSOCEAN|TRANSNATIONAL|TRANSPACIFIC|TRANSPAC|TRANSWEST|TRANSWESTERN|TRANSWORLD|INTERNTNAL|INTERNACIONAL
INTERNET|INTERNETWORK|INTERNETWORKING|INTRANET|INTRNET|INTRNT
INTERPRET|INTERPRETATION|INTERPRETER|INTERPRETING|INTERPRETIVE|INTRPRETING|INTRPRTING|INTRR
INTERSECT|INTERSECTION
INTERVENTION|INTERVENTIONAL|INTRVENTION|INTRVNTION|INTRVNTN
INTERVIEW|INTERVIEWING
INTIMACY|INTIMATE
INTRO|INTRODUCTION
INTRUDER|INTRUSION|INVADER|INVASION|INVASIVE|INTRUDE
INTUIT|INTUITION|INTUITIVE
INVENT|INVE|INVENTION|INVENTIVE|INVENTOR|INVENTORIE|INVENTORY|INVENTURE|INVNTORY|REINVENT
INVERSION|INVERSIONE|INVERTED|INVERT
INVEST|INVESCO|INVESMENT|INVESTCO|INVESTED|INVESTEMENT|INVESTER|INVESTM|INVESTME|INVESTMEN|INVESTMENTSINC|INVESTMENTSLLC|INVESTMETN|INVESTMNT|INVESTMT|INVESTO|INVESTR|INVETMENT|INVST|INVSTING|INVSTM|INVSTMENT|INVSTMNT|INVSTMT|INVSTOR|INVSTR|IVESTER|REINVESTMENT|IVESTMENT|INVESTMENT|INVESTOR|INVESTING
INVESTIGATE|INVESTGTN|INVESTI|INVESTIG|INVESTIGA|INVESTIGAT|INVESTIGATI|INVESTIGATING|INVESTIGATIO|INVESTIGATION|INVESTIGATIVE|INVESTIGATN|INVESTIGATOR|INVSTGATION|INVSTGATIVE|INVSTGTION|INVSTGTIVE|INVSTGTN|INVSTGTON|INVSTGTOR|INVSTIGATION|INVSTIGATIVE
INVITE|INVITATION|INVITATIONAL|INVITED|INVITING
INVOLVED|INVOLVEMENT|INVOLVE
ION|IONIA|IONIAN|IONIC
IRISH|IRISHMAN
IRON|IRONING|IRONWORK|IRONWORKER
IRREVOCABLE|IRREV|IRRV
IRRIGATION|IRRIGATE|IRRGATION|IRRGTION|IRRGTN|IRRI|IRRIG|IRRIGATI|IRRIGATIO
ISLAM|ISLAMIC|ISLAMORADA
ISLAND|ISLAN|ISLA|ISLANDER|ISLANDIA|ISLANDWIDE|ISLE|ISLND
ISRAEL|ISRAELI|ISRAELITE|ISREAL
ISSUE|ISSUER
ITALY|ITALIAN|ITAL|ITALIA|ITALIANA|ITALIANAMERICAN|ITALIANO|ITALO
ITCH|ITCHY
ITSY|ITTY
JACK|JACKED
JACKAL|JACKALOPE
JAIL|JAILHOUSE
JAMAICA|JAMAICAN
JANITOR|JANATORIAL|JANITORAL|JANITORI|JANITORIA|JANITORIAL|JANITA|JANITO|JANTORIAL|JANTR
JAPAN|JAP|JAPANESE|JAPENESE|JPANESE|JPN|JPNESE
JAZZ|JAZZERCISE|JAZZI|JAZZIE|JAZZY
JACKSON|JCKSNVILLE|JCKSNVLLE|JCKSON|JCKSONVILLE
JERICHO|JERICO
JEST|JESTER
JESU|JESUCRISTO|JESUIT
JET|JETCO|JETSET|JETSKI|JETSON|JETSTREAM|JETTER|JETTING
JEWEL|JEWELED|JEWE|JEWELER|JEWELERY|JEWELL|JEWELLER|JEWELLERY|JEWELR|JEWELRY|JEWELZ|JEWERLY|JEWL|JEWLER|JEWLERY|JEWLRY|JWL|JWLER|JWLR|JWLRY|JWLY
JEW|JEWISH|JWISH|JUDAISM|JUDAIC|JUDAICA|JUDAH
JOB|JOBBER|JOBBING|JOBSITE
JOCK|JOCKEY
JOIN|JOINE|JOINED|JOINER|JOINERY|JOINING|JOINT|JOINTLY|JOIST
JOKE|JOKER
JOURNAL|JOURNALISM|JOURNALIST|JRNL|JURNL
JOURNEY|JOURNEYMAN|JOURNEYMEN|JRNEY|JURNEY
JOY|JOYFUL|JOYERIA|JOYFULL|JOYFULLY|JOYLAND|JOYRIDE
JUBILANT|JUBILATION|JUBILEE
JUDGE|JDGMENT|JUDGEMENT|JUDGMENT|JUDI|JUDICE|JUDICIAL|JUDICIARY|JUSTICE|JUSTI|JSTICE|JUSTICIA|JUSTIFIED|JURISDICTION|JURY|JUST
JUGGLE|JUGGLER|JUGGLING
JUICE|JUICED|JUICERY|JUICY
JUKE|JUKEBOX
JUMP|JUMPER|JUMPIN|JUMPING|JUMPSTART
JR|JUNIOR|JNIOR
JUNCTION|JUNKTION
JUNK|JUNKY|JUNKYARD
JUVENILE|JUVE|JUVENAL|JUVENIL|JUVENTINO|JVNILE
KA|KANSAS|KANSAN
KARATE|KARATEDO|KARAT
KAWAII|KAWAI
KEEP|KEEPER|KEEPIN|KEEPING|KEEPSAKE|KPER
KENYA|KENYAN|KENYATTA|KENYETTA
KEY|KEYBOARD|KEYHOLE|KEYNOTE|KEYPOINT|KEYPORT|KEYSTONE|KEYSTROKE|KEYWAY|KEYWEST|KEYWORD|KEYZ
KICK|KIC|KICKAPOO|KICKBALL|KICKBOXING|KICKER|KICKIN|KICKING|KICKLIGHTER|KICKN|KICKSTAND|KICKSTART|KICKZ
KID|KIDCARE|KIDD|KIDDER|KIDDIE|KIDDIELAND|KIDDING|KIDDO|KIDDY|KIDO|KIDSTUFF|KIDSWEAR|KIDZ|KIDZONE|KINDER|KINDERCARE|KINDERGARTEN|KINDERHOOK|KINDERMUSIK
KIDNEY|KDNEY
KINEMATIC|KINESI|KINESIOLOGY|KINETIC|KINETIX
KITCHEN|KITCH|KITCHENETTE|KITCHENWARE|KITCHIN|KTC|KTCHEN|KTCHN|KITSCH
KITE|KITEBOARDING
KNEAD|KNEADED|KNEADING
KING|KINGDOM|KNG|KNGDM|KNGDOM
KNICK|KNICKER|KNICKERBOCKER
KNIGHT|KNGHT|KNIGHTDALE|KNIGHTLY|KNIGHTSBRIDGE
KNIT|KNITTED|KNITTER|KNITTING|KNITWEAR
KNIFE|KNIVE
KNOCK|KNOCKER|KNOCKERBALL|KNOCKOUT
KNOW|KNOWHOW|KNOWING|KNOWLDGE|KNOWLE|KNOWLEDGE|KNOWN|KNWLDGE
KNUCKLE|KNUCKLEHEAD
KOREA|KOREAN|KOREANA|KOREANAMERICAN|KREAN
KRYPTON|KRY|KRYPTONITE
KY|KENTUCKY|KENTUCKIANA
LA|LOUISIANA|LOUISANA|LOUISIANNA|LOUSIANA
LAB|LABORATORY|LABORATO|LABORATOR|LABORATORIE|LABORATORIO|LABORTORIE|LABORTORY|LABZ
LABEL|LABELING|LABLE
LABOR|LABER|LABO|LABORA|LABORER|LBOR
LAMINATE|LAMINATED|LAMINATING|LAMINATION|LAMINATOR
LAND|LANDA|LANDAMERICA|LANDBANK|LANDCAPE|LANDCAPING|LANDCARE|LANDCLEARING|LANDER|LANDERO|LANDES|LANDESIGN|LANDFAIR|LANDFALL|LANDFILL|LANDHOLDING|LANDIN|LANDING|LANDLORD|LANDMAN|LANDMARK|LANDO|LANDSCA|LANDSCAP|LANDSCAPE|LANDSCAPEING|LANDSCAPER|LANDSCAPI|LANDSCAPIN|LANDSCAPNG|LANDSCAPPING|LANDSCP|LANDSCPE|LANDSCPG|LANDSCPING|LANDSCPNG|LANDSLIDE|LANDSMAN|LANDWORK|LANSCAPE|LANSCAPING|LNDSCAPE|LNDSCP|LNDSCPE|LNDSCPG|LNDSCPING|LNDSCPNG|LAWN|LAWNCARE|MOW|MOWER|MOWIN|MOWING|LAWNMOWER|LAWNMOWING|LAWNSCAPE|SODDING|LAWNSCAPING|LAWNSERVICE|LAWNWORK|LWN|LANDSCAPING|LWNCARE|SCAPE|SCAPING|FOLIAGE|TREESCAPE|TURF|TURFGRAS|TURFGRASS|LDSCP|LDSCPG
LANGUAGE|LANGU|LANGUAG|LNGAGE|LNGE|LNGUAGE|LINGUISTIC|LINGO|LINGUA|LINGUAL
LASER|LASE|LASERWASH|LASIK|LAZER|LAZOR
LASH|LASHED
LAST|LASTER|LASTING
LATCH|LATCHKEY
LATE|LATELIER|LATENT|LATER|LATERAL
LATIN|LATINA|LATINAMERICAN|LATINI|LATINO|LATINOAMERICA|LATINOAMERICANA|LATINOAMERICANO|LATIOLAI|LTIN|LTINO|LATINX
LAUNDER|LAUNDERER|LAUNDERETTE|LAUNDERLAND|LAUNDERMAT|LAUNDR|LAUNDRAMAT|LAUNDRIE|LAUNDRO|LAUNDROMAT|LAUNDRY|LAUNDRYMAT|LDRY|LNDRY
LAYER|LAYERED|LAYING
LEAD|LEADER|LEADERSHIP|LADERSHIP|LEADERSHP|LEADING|LEADRSHP|LDER|LDERSHIP|LDRSHIP|LDRSHP|LEADED
LEAGUE|LEAG|LEAGU
LEAK|LEAKE|LEAKEY|LEAKY
LEAP|LEAPFROG|LEAPIN|LEAPING|LEAPT
LEARN|LEAR|LEARING|LEARNED|LEARNER|LEARNG|LEARNI|LEARNIN|LEARNING|LEARNNG|LRN|LRNG|LRNING|LRNNG
LEND|LEASE|LEASCO|LEASECO|LEASED|LEASEHOLD|LEASI|LEASIN|LEASING|LESSEE|LESSER|LESSING|LESSOR|LNDING|LND|LNDNG|LNDER|LOAN|LOANSTAR|HOMELOAN|BORROW|BORROWED|BORROWER
LEATHER|LEATH|LEATHERCRAFT|LEATHERMAN|LEATHERNECK|LEATHERWOOD|LEATHERWORK
LEAVE|LEAVER|LEAVING|LEAF|LEAFGUARD|LEAFY
LEBANESE|LEBA|LEBANON
LEFT|LEFTOVER|LEFTY
LEGACY|LEGACIE|LGACY
LEGEND|LEGENDARY|LEGENDZ
LEGISLATE|LEGISLATIVE|LEGISLATURE
LEGIT|LEGITIMATE
LETTER|LETTERING|LETTERMAN|LETTERPRES
LEVEE|LEVE|LEVY
LEVEL|LEVELING|LVL
LEVER|LEVERAGE|LEVERAGED|LEVERING
LEGION|LGION
LIABILITY|LIAB|LIABI|LIABIL|LIABILI|LIABILIT|LIABILTY|LBLTY|LIABLITY
LIBERAL|LIBERATED|LIBERATION|LIBERATO|LIBERATOR|LIBERATORE
LIBERIA|LIBERIAN
LIBERTY|LIBERTARIAN|LIBERTE|LIBERTIE|LIBERTO|LBRTY|LBERTY
LIBRARY|LIBRARIAN|LIBRAR|LIBRARIE|LBRY|LIBRE|LIBRERIA|LIBRI
LICENSE|LCN|LCNSD|LCNSE|LCNSED|LCE|LCENSED|LICENSED|LICENSEE|LICENSING
LIFE|LFSTYLE|LFESTYLE|LIFEBRIDGE|LIFECARE|LIFECYCLE|LIFEFORCE|LIFEGUARD|LIFEHOUSE|LIFELINE|LIFELINK|LIFELONG|LIFEPATH|LIFEPOINT|LIFEQUEST|LIFER|LIFESAVER|LIFESAVING|LIFESCAPE|LIFESCIENCE|LIFESKILL|LIFESONG|LIFESOURCE|LIFESPAN|LIFESPRING|LIFESTAR|LIFESTREAM|LIFESTYLE|LIFETIME|LIFETOUCH|LIFEWAY|LIFEWORK|LIF|LIVE|LIVABLE|LIVA|LIVELY|LIVIN|LIVING|LIVNG|LVING|LVNG
LIFT|LFT|LIFTED|LIFTER|LIFTING
LIGHT|LIGH|LIGHTBULB|LIGHTCAP|LIGHTED|LIGHTEN|LIGHTENING|LIGHTER|LIGHTFOOT|LIGHTHOUSE|LIGHTHUSE|LIGHTING|LIGHTLE|LIGHTLY|LIGHTMAN|LIGHTNER|LIGHTNIN|LIGHTNING|LIGHTSCAPE|LIGHTSEY|LIGHTSHIP|LIGHTSOURCE|LIGHTSPEED|LIGHTSTONE|LIGHTWAVE|LIGHTWEIGHT|LIGHTWORK|LIGHTYEAR|LGHT|LGHTHOUSE|LGHTHUSE|LGHTNING|LITE|LITEHOUSE|LUMIERE|LUMIN|LUMINA|LUMINARY|LUMINOSITY|LUMINOU
LIKE|LIKELY|LIKEN
LIME|LIMEHOUSE|LIMELIGHT|LIMERICK|LIMESTONE
LIMIT|LIMITADA|LIMITE|LIMITED|LIMITLES|LIMTED
LIMOUSINE|LIMOSINE|LIMOSNE|LIMOU|LIMOUSIN|LIMO|TOWNCAR
LINE|LINEA|LINEAGE|LINEAR|LINED|LINEMAN|LINEN|LINER|LINEUP
LIQUOR|LIQOUR|LIQ|LIQUEUR
LIQUID|LIQUI|LIQUIDATE|LIQUIDATING|LIQUIDATION|LIQUIDATOR|LIQUIDITY|LQUIDATOR
LIST|LISTED|LISTER|LISTING
LISTEN|LISTENER|LISTENING
LITERACY|LITERARY|LITERATURE|LTERACY|LTRACY
LITHOGRAPH|LITH|LITHIA|LITHO|LITHOGRAPHER|LITHOGRAPHIC|LITHOGRAPHING|LITHOGRAPHY|LITHONIA
LIVESTOCK|LVSTK
LOAD|LOADED|LOADER|LOADING|UNLOADING|UNLOAD
LOAF|LOAFER
LOCAL|LOC|LOCA|LCL|LOCALE|LOCALLY
LOCATE|LOCATED|LOCATER|LOCATING|LOCATION|LOCATOR|RELOCATION|RELOCATOR|RLCATION|RLCTION|RLO|RLOCATION
LOCK|LCK|LCKSM|LCKSMT|LCKSMTH|LOCKBOX|LOCKDOWN|LOCKED|LOCKER|LOCKET|LOCKEY|LOCKING|LOCKMAN|LOCKOUT|LOCKSHOP|LOCKSM|LOCKSMI|LOCKSMIT|LOCKSMITH|LOCKSMITHING|LOCKSMTH|LKR
LOCOMOTION|LOCO|LOCOCO|LOCOMOTIVE|LOCOMTIVE
LODGE|LODG|LDG|LDGE|LDGING|LODGEPOLE|LODGING
LOFT|LOFTY
LOG|LOGGER|LOGIN|LOGGIN|LOGGING
LOGIC|LOGIK|LOGISTIC|LOGI|LOGIA|LOGICAL|LOGISITC|LOGISITIC|LOGIST|LGISTIC|LOGISTI|LOGISTICA|LOGISTICAL|LOGISTIX|LOGIX|LGSTIC
LONE|LONELY|LONESOME|LONESTAR|LONETREE|LONEWOLF|SOLO
LONG|LONGER|LONGEST
LOOK|LOOKER|LOOKIN|LOOKING|LOOKOUT
LOVE|LOVABLE|LOVATO|LOVEABLE|LOVEBUG|LOVED|LOVELY|LOVER|LOVEY|LOVIE|LOVIN|LOVING
LOW|LOWER|LOWEST
LOYAL|LOYALTY
LITTLE|LTTLE|LIL
LUBE|LUBRICANT|LUBRICATING|LUBR|LUBRICATION
LUMBER|LUMBERJACK|LUMBERMEN|LUMBERYARD
LUNAR|LUNA|LUNATIC
LUNCH|LUNCHBOX|LUNCHE|LUNCHEON|LUNCHEONETTE
LUST|LUSTER|LUSTRE
LUTHERAN|LTH|LTHERAN|LTHRAN|LTHR|LUTHERN|LUTHRN|LUTHER|LUTH
LUXURY|LUXURIOU|LUXX|LXURY|LUXE
LYMPHATIC|LYMPHEDEMA
LYRIC|LYRICAL
MA|MASSACHUSETT|MASSA|MASSAC|MASSACHSTT|MASS
MACHINE|MACH|MACHI|MACHIN|MACHINA|MACHINED|MACHINERY|MACHINING|MACHINIST|MCHENRY|MCHINING|MECHANIC|MEC|MECA|MECANICA|MECANICO|MECCA|MECH|MECHA|MECHAM|MECHAN|MECHANCAL|MECHANCIAL|MCHNIC|MCHNING|MECHANI|MECHANICA|MECHANICAL|MECHANISM|MECHANIX|MECHATRONIC|MECHNICAL
MADAM|MADAME|MADEMOISELLE|MLLE
MAESTRO|MAESTRI|MASTRO
MAJESTIC|MAJESTIK|MAJESTY
MAGIC|MAGICA|MAGICAL|MAGICIAN|MAGICK|MAGICKAL|MAGICO|MAGIK|MAJIC|MAJIK|MGIC
MAGNET|MAGNETIC|MAGNETO|MGNT|MGNTIC|ELECTROMAGNETIC|ELECTROMAGNET
MAGNIFICENT|MAGNI|MAGNIFICAT|MAGNIFICO|MAGNIFIQUE|MAGNIFICENCE
MAID|MAIDEN|MAIDPRO|MAIDSTONE
MAIL|MAILBOX|MAILBOXE|MAILE|MAILER|MAILING|MAILMAN|MAILROOM
MAIN|MAINLY|MAINELY|MAINFRAME|MAINGATE|MAINLAND|MAINLINE|MAINSAIL|MAINSPRING|MAINSTAY|MAINSTREAM|MAINSTREET
MAINTAIN|MAINT|MAINTAINANCE|MAINTAINCE|MAINTAINENCE|MAINTANANCE|MAINTANCE|MAINTANENCE|MAINTE|MAINTEANCE|MAINTEN|MAINTENA|MAINTENACE|MAINTENAN|MAINTENANC|MAINTENCE|MAINTENENCE|MAINTNANCE|MAINTNCE|MAINTNNC|MAINTNNCE|MAITENANCE|MANTENANCE|MANTENIMIENTO|MNT|MNTAIN|MNTE|MNTIN|MNTN|MNTNC|MNTNCE|MNTNNCE|MAINTENANCE
MAJOR|MAJORCA|MAJORIE|MAJORITY|MAIORCA
MALAYSIA|MALAYSIAN
MANAGE|MAN|MANA|MANAG|MANAGAMENT|MAMAGEMENT|MANAGEM|MANAGEMANT|MANAGEME|MANAGEMEN|MANAGEMENT|MANAGEMENTINC|MANAGEMENTLLC|MANAGEMNET|MANAGEMNT|MANAGERIAL|MANAGMNT|MANANGEMENT|MANGEMENT|MANGMENT|MANGMNT|MGMNT|MGMT|MGR|MMENT|MNAGEMENT|MNAGER|MNAGMENT|MNG|MNGED|MNGEMENT|MNGER|MNGMENT|MNGMNT|MNGMT|MNGR|MNGT|TELEMANAGEMENT|MANAGER|MGT|MANAGED|MANAGMENT|MANAGING
MANCHESTER|MANCHSTER
MANHATTAN|MANHATTEN
MANIA|MANIAC|MANIACI|MANIC
MANICURE|MANI|MANICURING|MANICURIST
MANIFEST|MANIFESTATION|MANIFESTED
MANUFACTURE|MANUFACTORING|MANUFACTORY|MANUFACTUR|MANFACTURING|MANUFACTURER|MANUFACTURIN|MANUFCTRING|MFG|MANUF|MANU|MNUFACTURED|MNF|MNFACTURED|MNFCTRED|REMANUFACTURED|REMANUFACTURING|MANUFACTURING|MANUFACTURED
MAP|MAPPING
MARCH|MARCHI|MARCHING
MARGARITA|MARGHERITA|MARGARITAVILLE
MARGIN|MARGINAL
MARINE|MARITIME|MRTIME
MARK|MARKER|MARKED|MARKSMAN|MARKMAN|MARKSMANSHIP|MARKSMEN
MARKET|MARKETA|MARKETEER|MARKETER|MARKETI|MARKETIN|MARKETING|MARKETNG|MARKIT|MARKT|MARKTING|MARKTNG|MERCADITO|SUPERMARKET|SPRMKT|SUPERMART|TELEMARK|TELEMARKETING|SUPERMERCADO|SWAP|SWAPMEET|STORZZ|SELL|SELLER|SELLING|SOLD|MERCADO|MERCANTILE|MERCATO|MINIMARKET|MINIMART|MKG|MKING|MKT|MKTING|MKTNG|MRK|MRKETPLACE|MRKT|MRKTG|MRKTING|MRKTNG|MRKTPLACE|EMARKETING|GROCERY|GROCERIE|REMARKETING|RESELL|RESELLER|MARKETPLACE|MRTG|MKTG|MARKETTING
MASON|MASN|MASNRY|MASONARY|MASONERY|MASONRY|MSNIC|MSNRY|MSO|MSON|MSONIC
MASSAGE|MASAGE|MASSAG|MASSGE
MASTECTOMY|MASTEC
MASTER|MASTERCARE|MASTERCRAFT|MASTERFUL|MASTERGUARD|MASTERING|MASTERMIND|MASTERPIECE|MASTERPLAN|MASTERTECH|MASTERWORK|MASTERY|MASTERZ|MST|MSTER|MSTR|MASTR
MATCH|MATCHA|MATCHBOX|MATCHE|MATCHETT|MATCHING|MATCHLES|MATCHMAKER|MATCHMAKING|MATCHPOINT
MATERIAL|MATER|MATERA|MATERIA
MATERNAL|MATERNITY
MATH|MATHEMATIC|MATHA|MATHE|MATHEMATICAL
MATRIX|MATRIXX
MATURE|MATURITY
MAVERICK|MAVRICK
MAX|MAXIMUM|MAXAM|MAXCY|MAXEY|MAXI|MAXIE|MAXILLOFACIAL|MAXIM|MAXIMA|MAXIME|MAXIMINO|MAXIMIZE|MAXIMIZED|MAXIMO|MAXIMU|MAXIUM|MAXUM|MAXX
MAYOR|MAYORAL
MD|MARYLAND|MARYLANDER
ME|MAINE|MAINER
MEANING|MEANINGFUL
MEASURE|MEASURED|MEASUREMENT|MEASURING
MEAT|MEATBALL|BUTCHER|SAUSAGE
MEDIA|MDIA|MEDIAWORK|MEDIACOM|EMEDIA
MEDIATION|MDATION|MEDIATOR|MDIATION|MDTION|MEDIATE
MEDICAL|MEDIC|MEDICA|MDCAL|MDCINE|MDCL|MDCN|MDCNE|MEDICALDENTAL|MEDICALLEGAL|MEDICALLY|MEDICAR|MEDICARE|MEDICATION|MEDI|MEDICENTER|MEDICI|MEDICIN|MEDICINA|MEDICINAL|MEDICINE|MEDICL|MEDICLAIM|MEDICO|MEDICOLEGAL|MEDICU|MEDICAID|MEDIO|MEDIPLEX|MEDITECH|MEDISPA|MEDLEGAL|MDIC|MDICAL|MDICINE|MDISON|MDSON|MEDHEALTH|MEDEXPRES|MEDCAL|MEDCARE|MEDCENTER|MEDCL|MEDCN|MEDCNE|MEDCO|MEDCOM|MEDEQUIP|MEDER|MEDERO|MEDEX|MED|MEDIX|MEDLIN|MEDLINE|MEDLINK|MEDLOCK|MEDNET|MEDITERRANEAN|MEDITERRANEA|MEDITERRANEO|MDTRRNEAN|MEDPRO|MEDSERV|MEDSOURCE|MEDSPA|MEDSTAFF|MEDSTAR|MEDTECH|MEDTRAN|MEDTRONIC|MEDWAY|MEDX|TELEMED|TELEMEDICINE
MEET|MEETING|MEETINGHOUSE
MEGA|MEGABYTE|MEGASTAR|MEGASTORE
MELODY|MELODEE|MELODIC|MELODIE
MELT|MELTDOWN|MELTED|MELTING
MEMBER|MBR|MEMBERSHIP|MEM|MMB|MMBER
MEMBRANE|MEMBRENO
MEMORY|MEMORIAL|MEMORI|MEMORIA|MEMORIE|MEMORABLE|MEMOR|MEMORABILIA|MEMENTO|MEMOIR|MEMORL|MEMRL|MMRIE|MMORIE|MMORY|MMRL
MEND|MENDING
MENTAL|MENTALITY|MENTALLY|MENTE|MENTI|MENTL|MENTO|MNTAL|MNTL
MENTOR|MENTORING|MENTORSHIP
MERCHANT|MERCH|MERCHAN|MERCHAND|MERCHANDI|MERCHANDISE|MDSC|MDSE|MDSG|MERCHANDISER|MERCHANDISING|MERCHANDIZING|MARCHANT|MERCHANTILE|MRC|MRCH|MRCHANT|MRCHNT
MERGE|MERGED|MERGEN|MERGER|MERGING
MESSAGE|MESSAGING|MESSENGER|MSG|MSGNR|MSGR|MSSAGE|MSSG|MSSGE
MESSIAH|MESSIANIC
METABOLIC|METABOLIFE|METABOLISM
METAL|METALCRAFT|METALFAB|METALIZING|METALLIC|METALLURGICAL|METALSMITH|METALWORK|METALWORKING|METL|MTAL|MEDAL|MEDALIST|MEDALLION|MEDL
METAPHYSIC|METAPHYSICAL
METER|METERING
METH|METHADONE|METHAMPHETAMINE
METHODIST|METHDST|METHO|METHOD|METHODI|METHODST|MTH|MTHDST
METRO|METROCREST|METROLINA|METROLOGY|METROMEDIA|METRON|METROPC|METROPLEX|METROPLITAN|METROPLTAN|METROPOL|METROPOLE|METROPOLI|METROPOLITAN|METROPOLITIAN|METROTECH|METROWEST|MTRO
MEXICAN|MEX|MEXI|MEXIA|MEXIC|MEXICA|MEXICALI|MEXICANA|MEXICANAMERICAN|MEXICANO|MEXICO|MX|MXCAN|MXICAN|MXICO
MI|MICHIGAN
MIAMI|MIAMIDADE|MIAMISBURG
MICROBE|MICROBIAL|MICROBIOLOGY
MIDWEST|MDWEST|MIDWESTERN
MIDWIFE|MIDWIFERY|MIDWIVE|DOULA
MIGHT|MIGHTY
MIGRANT|MIGRATION
MILE|MILEAGE|MILEPOST|MILER|MILESTONE
MILITARY|MILITANT|MILITARIA|MILITELLO|MILITIA|MLITARY|MLT|MLTARY|MLTRY|SOLDIER
MILK|MILKMAN|MILKY
MILLENNIUM|MILLENIUM|MILENIUM|MILLENIAL|MILENIO|MILLENNIA|MILLENNIAL|MILLINIUM|MLLNNIUM
MILLION|MILLIONAIRE
MIND|MINDBODY|MINDED|MINDER|MINDFUL|MINDFULNES|MINDING|MINDSET|MINDWORK|MINDZ
MINE|MINER|MINERA|MINERAL|MINING|MNRAL|MNRL
MINI|MINIATURE
MINIMAL|MINIMALLY|MINIMAX|MINIMUM
MINISTER|MINIST|MINISTERIE|MINISTERIO|MINISTERY|MINISTIE|MINISTIRE|MINISTR|MINISTRI|MINISTRIE|MINISTRIESINC|MINISTRIO|MINISTRY|MINSTER|MINSTR|MINSTRIE|MINSTRY|MINSTREL|MNISTRIE|MNISTRY|MNST|MNSTER|MNSTR|MNSTRIE|MNSTRY|MINISTERIAL
MINOR|MINORITIE|MINORITY|MNRITY
MINT|MINTER
MINUTE|MINUTEMAN|MINUTEMEN
MISC|MISCELLANEOUS
MISSION|MISSIO|MISION|MISIONERA|MISIONERO|MISSIONARIE|MISSIONARY|MISSIONRY|MISSN|MISSNRY|MISSON|MISSONARY|MSSION|MSSIONARY|MSSN|MSSNARY|MSSNRY|MSSON|MSSONARY
MIX|MIXE|MIXED|MIXER|MIXING|MIXOLOGY|MIXTURE|MIXX
MAKEUP|MKEUP
MN|MINNESOTA|MINN|MINNESOTAN
MO|MISSOURI|MISSOURIAN
MOBILE|MOBIL|MBLE|MBLITY|MOBILEHOME|MOBILI|MOBILITY|MOBILIZATION|MOBLE
MODE|MODAL
MODEL|MDEL|MODELER|MODELING|MODELL|MODELO|MDL|MDLING
MODERN|MODERNE|MODERNIZATION|MODERNA|MODERNIZING|MODERNO|MODRN
MODEST|MODESTA|MODESTO|MODESTY|MODERATE
MODIFICATION|MODI|MODICA|MODIFIED|MODIFY
MODULE|MODULAR|MODU
MOLD|MOLDING|MOULD|MOULDER|MOULDING|MOLDER
MOLECULE|MOLE|MOLECULAR
MOM|MOTHER|MOTHERHOOD|MOTHERLAND|MOTHERLODE|MOTHERSHIP
MOMENT|MOMENTO|MOMENTUM
MONARCH|MONARCHY|MONARK
MONEY|MNEY|MONEYMAKER|MONEYTREE|MONETARY
MONITOR|MONITORING|MNITORING|MNTORING|MNTRING
MONKEY|MONKEE
MONOGRAM|MONOGRAMING|MONOGRAMMING
MONOLITH|MONOLITHIC
MONTGOMERY|MNTGMERY|MNTGOMERY|MONTGMERY|MONTGOMERYVILLE
MONTH|MONTHLY
MONUMENT|MONUMENTAL
MOON|MOONBEAM|MOONDANCE|MOONDOG|MOONEY|MOONEYHAM|MOONGLOW|MOONLIGHT|MOONLIGHTING|MOONLIT|MOONLITE|MOONRISE|MOONSHADOW|MOONSHINE|MOONSTAR|MOONSTONE|MOONSTRUCK|MOONWALK
MOOR|MOORAGE
MORMON|MORMAN
MORN|MORNING|MORNINGSIDE|MORNINGSTAR
MOROCCO|MOROCCAN
MORTGAGE|MORTAGAGE|MORT|MORTAGE|MORTG|MORTGA|MORTGAG|MTGE|MRT|MRTGAGE
MORTUARY|MORTICIAN|MORTUARIE
MOTIVE|MOTION|MOTIV|MOTIVATE|MOTIVATED|MOTIVATING|MOTIVATION|MOTIVATIONAL|MOTIVATOR
MOTOR|MOTORBIKE|MOTOCROS|MOTORCAR|MOTORCITY|MOTORCOACH|MOTORCROS|MOTORCYCLE|MOTORCYCLIST|MOTORCYLE|MOTORHEAD|MOTORHOME|MOTORING|MOTORIST|MOTORIZED|MOTOROLA|MOTORPLEX|MOTORSPORT|MOTORWERK|MOTORWORK|MOTORZ|MOTOSPORT|MTCYC|MTORCYCLE|MTORSPORT|MTR|MTRCYCLE|MTRSPORT|MTRSPRT|AUTOMOTIVE|AUTOMOTIV|AUTOMTIVE|AUTOMTV|CAR|VEHICLE|VHCL|VHCLE
MOVE|MOV|MOVEABLE|MOVED|MOVEMENT|MOVER|MOVIN|MOVING|MVE|MVEMENT|MVER|MVG|MVM|MVMENT|MVR
MOVIE|MOVIELAND
MIRACLE|MRCLE
MERCY|MRCY
MS|MISSISSIPPI|MISSISSPPI
MT|MOUNT|MOUNTAINEER|MOUNTAINEERING|MOUNTAINLAND|MOUNTAINSIDE|MOUNTAINTOP|MOUNTAINVIEW|MOUNTAINWEST|MOUNTED|MOUNTIAN|MOUNTING|MOUNTJOY|MOUNTN|MOUTAIN|MOUTON|MUNTAIN|MONTANA|MOUNTAIN|MTN
MUD|MUCK|MUDBUG|MUDDER|MUDDY|MUDJACKING
MUFFLER|MFFLER
MUG|MUGSHOT
MULCH|MULCHING
MULE|MULESHOE
MULTI|MULT|MLTI|MULTICARE|MULTICOLOR|MULTICRAFT|MULTICULTURAL|MULTIFAMILY|MULTIHOUSING|MULTILINE|MULTILINGUAL|MLTIMEDIA|MLTMDIA|MULTIMEDIA|MULTIMODAL|MULTINATIONAL|MULTIPLE|MLTPLE|MULTIPLEX|MULTIPLIER|MULTIPURPOSE|MULTISERVICE|MULTISERVICIO|MULTISPECIALTY|MULTISPORT|MULTISTATE|MULTISTRATEGY|MULTITASK|MULTITECH
MUNICIPAL|MNC|MNCPL|MUNICIPALITY|MUNICIPIO|MUNICPAL|MUNICPL|MNI|MNICA|MNICPL|MUNI
MUSCULAR|MUSCULOSKELETAL
MUSEUM|MSEUM
MUSIC|MSIC|MUSICA|MUSICAL|MSCAL|MUSICIAN|MUSICWORK|MUSIK|MUSIQ|MUSIQUE|MUSICALE|MUSICK
MYOFASCIAL|MYOTHERAPY|MYOFACIAL
MYSTERY|MYST|MYSTERIE|MYSTERIOU|MYSTIC|MYSTICAL|MYSTIK|MYSTIQUE
MYTH|MYTHIC|MYTHICAL|MYTHO|MYTHOLOGY|MYTHOLOGICAL
NAIL|NAILED|NAILSPA|NAILZ
NANO|NANOTECH|NANOTECHNOLOGY
NASHVILLE|NASHVLLE|NSHVLLE
NATION|NACIONE|NATIONA|NATIONAL|NACIONAL|NATIONL|NATIO|NATL|NATNL|NTION|NTL|NTN|NTNL|NTNWIDE|NATIONWIDE|NATIONWDE
NATIVE|NATIV|NATIVIDAD|NATIVITY|NTIV
NATURAL|NATU|NATUR|NATURA|NATRL|NATURALE|NATURALIST|NATURALLY|NATURE|NATUREL|NATURELLE|NATURESCAPE|NATURISTA|NATUROPATHIC|NTRL|NTURAL|NTURE
NAUTICAL|NAUTI|NAUTIC|NAUTICA|NAUTILU
NAVAL|NAV|NAVA|NAVY
NAVIGATE|NAVIGATING|NAVIGATION|NAVIGATOR
NAZARENE|NAZAREGE|NZARENE|NZRENE
NE|NEBRASKA
NEAR|NEARLY
NECESSARY|NECESSITIE|NECESSITY
NECK|NECKLACE|NECKWEAR
NEED|NEEDED|NEEDFUL|NEEDY
NEEDLE|NEEDLEART|NEEDLECRAFT|NEEDLEPOINT|NEEDLEWORK
NEGATIVE|NEG
NEGOTIATION|NEGOTIATOR|NEGOCIO
NEIGHBORHOOD|NEIGH|NEIGHBOR|NEIGHBORHD|NEIGHBORLY|NEIGHBOUR|NEIGHBRHD|NEIGHBRHOD|NEIGHBRHOOD|NGHBORHOOD|NGH|NGHBOR|NGHBRHD|NGHBRHOOD|NIGHBORHOOD
NEONATAL|NATAL|NEONATOLOGY
NEPAL|NEPALESE
NERD|NERDY
NETWORK|NETW|NETWK|NETWO|NETWOR|NETWORKCOM|NETWORKED|NETWORKER|NETWORX|NETWRK|NTW|NTWK|NTWORK|NTWORKING|NTWRK|NTWRKING|NETWORKING
NEUROLOGY|NEUROBEHAVIORAL|NEUROCARE|NEURODIAGNOSTIC|NEUROFEEDBACK|NEUROLOGIC|NEUROLOGICAL|NEUROMONITORING|NEUROMUSCULAR|NEURON|NEUROPATHY|NEUROPHYSIOLOGY|NEUROPSYCHIATRIC|NEUROPSYCHOLOGICAL|NEUROPSYCHOLOGY|NEUROSCIENCE|NEUROSURGERY|NEUROSURGICAL|NEUROTHERAPY|NRLOGY
NEWS|NEWSPAPER|NEWSLETTER|NEWSPPR|NEWSROOM|NEWSSTAND|NEWSTAND|NEWSWANGER
NIAGARA|NIAGRA
NICARAGUA|NICARAGUAN
NIGER|NIGERIA|NIGERIAN
NIGHT|NIGH|NGHT|NIGHTCLUB|NIGHTENGALE|NIGHTHAWK|NIGHTINGALE|NIGHTLIFE|NIGHTLIGHT|NIGHTMARE|NIGHTOWL|NITE|NITECLUB|NITELIFE|NOIR|NOIRE
NITRO|NITROGEN
NOBLE|NOBEL|NOBILE|NOBILITY|NOBLESVILLE
NOISE|NOISY|NOIZE
NOMAD|NOMADIC
NONPROFIT|NNPRFIT|NNPROFIT|NOTFORPROFIT
NOREASTER|NOREAST
NORMAL|NORM|NRM
NORSE|NORSEMAN|NORSEMEN
NORTH|NORTHAM|NORTHAMERICAN|NORTHAMPTON|NORTHAST|NORTHBAY|NORTHBELT|NORTHBORO|NORTHBOROUGH|NORTHBOUND|NORTHBRIDGE|NORTHBROOK|NORTHCENTRAL|NORTHCOAST|NORTHCOTT|NORTHCREST|NORTHCROS|NORTHCUTT|NORTHDALE|NORTHE|NORTHEAST|NORTHEASTERN|NORTHEN|NORTHEND|NORTHER|NORTHERN|NORTHFIELD|NORTHFORK|NORTHGATE|NORTHGLENN|NORTHINGTON|NORTHLAKE|NORTHLAND|NORTHLIGHT|NORTHLINE|NORTHMONT|NORTHPARK|NORTHPOINT|NORTHPOINTE|NORTHPORT|NORTHRIDGE|NORTHRN|NORTHROP|NORTHRUP|NORTHSHORE|NORTHSIDE|NORTHSOUTH|NORTHSTAR|NORTHSTATE|NORTHSTERN|NORTHTOWN|NORTHTOWNE|NORTHUMBERLAND|NORTHUP|NORTHVALE|NORTHVIEW|NORTHVILLE|NORTHWAY|NORTHWE|NORTHWEST|NORTHWESTERN|NORTHWIND|NORTHWOOD|NORTHWST|NORTHWSTERN|NORWEST|NRTH|NRTHAST|NRTHEAST|NRTHRN|NTHRN
NORWAY|NORWEGIAN
NOSTALGIA|NOSTALGIC
NOTABLE|NOTARIAL|NOTARIE|NOTARO|NOTARY
NOTE|NOTEBOOK|NOTEBOOM|NOTED|NOTEHOLDER|NOTHERN
NOTHING|NOTHIN
NOTICE|NOTIFICATION|NOTIFY
NOURISH|NOUR|NOURI|NOURISHED|NOURISHING|NOURISHMENT
NOVEL|NOVELL|NOVELLA|NOVELLI|NOVELLO|NOVELTIE|NOVELTY
NUBIA|NUBIAN
NUCLEAR|NUCLEU
NUMBER|NMBER|NUMERIC|NUMERICAL|NUMERO
NURSE|NRSE|NRSING|NRSNG|NURSER|NURSING|NURSNG
NURSERY|NURSERIE|NRSRY|SHRUB|NURSURY
NURTURE|NURTURED|NURTURING
NUTRITION|NUTR|NUTRA|NUTRACEUTICAL|NUTRI|NUTRICEUTICAL|NUTRICION|NUTRIENT|NUTRISHOP|NTRTIONAL|NUTRITIONAL|NUTRITIONIST|NUTRITIOU
NV|NEVADA|NEV|NEVA|NEVADAN
OBSERVATION|OBSERVATORY|OBSERVER|OBSESSED
OBSESSION|OBSESSIVE
OBSTETRIC|OBSTETRICAL|OBSTTRIC|OBST|OBSTETRICIAN
OCCASION|OCASSION|OCCASIONAL|OCCASSION|OCCSION|OCCSON
OCCUPATION|OCCPATIONAL|OCCPTIONAL|OCCPTNAL|OCCPTNL|OCCPTONAL|OCCUPATIONAL|OCCUPTNAL|OCCUPTNL|OCCUPY|OCCU|OCCUP|OCCUPANT
OCEAN|OCEANA|OCEANFRONT|OCEANIA|OCEANIC|OCEANO|OCEANSIDE|OCEANU|OCEANVIEW|OCEANWAY
OFFER|OFFERING|OFER
OFFICE|OFFICIAL|OFFICAL|OFFCIAL|OFFCL|OFFFICE|OFC|OFFC|OFFCE|OFFI|OFFIC|OFFICER|OFFCER|OFFCR|OFFICIANT|OFFICIATING|OFFCAL|OFCE|OFCR|OFI|OFICE|OFICINA
OH|OHIO|OHIOAN
OIL|OIL2|OILER|OILFIELD|OILFLD|OILWELL|OILY
OK|OKLAHOMA|OKLAHOMAN|OKIE
OLYMPIA|OLY|OLYMPIAD|OLYMPIAN|OLYMPIC
OMBUDSMAN|OMB|OMBUD|OMBUDSPERSON
ONLINE|ONLINECOM
OPEN|OPENDOOR|OPENER|OPENING
OPERATE|OPERATOR|OPER|OPERAT|OPERATED|OPERATING|OPERATION|OPERATIONAL|OPERATIVE|OPR|OPRATION|OPRTION|OPRTNTY|OPRTON|OPRTOR
OPHTHALMIC|OPHTHALMOLOGY
OPPORTUNITY|OPPORT|OPPORTUNISTIC|OPPORTUNIT|OPPORTUNITE|OPPORTUNITIE|OPPRTNITIE|OPPRTNITY|OPPRTNTIE|OPPRTNTY|OPPRTUNITIE|OPPRTUNITY
OPERA|OPRY
OPTICAL|OPTCAL|OPTHALMIC|OPTHALMOLOGY|OPTI|OPTIC|OPTICA|OPTICIAN|OPTIK|OPTIQUE|OPTMTRST|OPTO|OPTOELECTRONIC|OPTOMETRIC|OPTOMETRIST|OPTOMETRY|OPTIX|OPTRONIC
OPTIMAL|OPT|OPTIM|OPTIMA|OPTIMIST|OPTIMISTIC|OPTIMIZATION|OPTIMIZE|OPTIMIZED|OPTIMIZER|OPTIMO|OPTIMU|OPTIMUM|OPTUM
OPTION|OPTIONAL
OPULENT|OPULENCE
OR|OREGON
ORBIT|ORBI|ORBITAL
ORCHESTRA|ORCH|ORCHSTRA
ORCHARD|ORCHRD
ORDER|ORDERED|ORDERING|ORDERLY|ORDINANCE|ORDINARY|ORDNANCE|ORDR
ORG|ORGA|ORGAN|ORGANI|ORGANIC|ORGANICA|ORGANICALLY|ORGANISATION|ORGANIX|ORGANIZ|ORGANIZA|ORGANIZACION|ORGANIZAT|ORGANIZATI|ORGANIZATIO|ORGANIZATION|ORGANIZATIONAL|ORGANIZE|ORGANIZED|ORGANIZER|ORGANIZING|ORGANZTION|ORGNIZATION|ORGN|ORGNZATION|ORGNZING|ORGNZTION|ORGNZTN|ORGNIC
ORIENT|ORIENTAL|ORIENTATION|ORIENTE|ORIENTED|ORIEN
ORIGIN|ORGINAL|ORIGEN|ORIGINAL|ORIGINATION|ORIGINATOR|ORIG|ORGNAL
ORNAMENT|ORNAMENTAL|ORNATE
ORPHAN|ORPHA|ORPHANAGE|ORPHANED
ORTHODOX|ORTHDOX|ORTHDX
ORTHODONTIC|ORTHODONIC|ORTHDNTIC|ORTHDONTIC|ORTHODONTIST|ORTHOPAEDIC|ORTHOPDC|ORTHOPDIC|ORTHOPEDIC|ORTHOTIC|ORTHPAEDIC|ORTHPD|ORTHPDC|ORTHPDIC|ORTHPEDIC|ORTHTIC|ORTHO|ORTHODONTIA
OSTEO|OSTEOPATHIC|OSTEOPOROSI|OSTEOPATH
OUTFIT|OTFITTER|OTFTTER|OUTFITTER|OUTFITTING|OUTERWEAR
OUTPATIENT|OTPATIENT|OTPTENT|OTPTIENT
OUTER|OUTR
OUTREACH|OTRACH|OTRCH|OTREACH|OUTRCH|OUTRE|OUTREA|OUTREAC
OUTSIDE|OUTSIDER
OUTSOURCE|OUTSOURCED|OUTSOURCING
OWN|OWNER|OWNED|OWNE|OWNERSHIP|OWNR
OXYGEN|OXGN|OXY
PA|PENNSYLVANIA
PACE|PACEMAKER|PACER|PACESETTER
PACIFIC|PACFIC|PACIFICA|PACIFICO|PNW
PACK|PACKAGE|PACKAGED|PACKAGING|PACKED|PACKER|PACKERLAND|PACKET|PACKG|PACKING|PACKMAN|PACKRAT|PACKWOOD|PCK|PCKG
PAGEANT|PAGEANTRY|PAGENT
PAGE|PAGER|PAGING
PAINT|PAINTBALL|PAINTBRUSH|PAINTED|PAINTER|PAINTG|PAINTI|PAINTIN|PAINTING|PAINTLES|PAINTNG|PAINTWORK|PAIT|PAITING|PANTING|PAYNTER|PNTING|PNTNG|PNTR|PRIMER|REPAINT
PAKISTAN|PAKISTANI
PALACE|PALACIO
PAMPER|PAMPERED|PAMPERING
PANEL|PANELING
PANORAMA|PANORAMIC
PAPER|PAPERBACK|PAPERBOARD|PAPERHANGER|PAPERHANGING|PAPERIE|PAPERING|PAPERLES|PAPERMILL|PAPERWORK|PARCHMENT
PARADISE|PAIRADICE|PARADICE|PARADISO|PARIDISE|PRADISE|PRDISE
PARALEGAL|PRALEGAL|PRLGAL
PARAMEDIC|PARAMED|PARAMEDICAL
PARAMOUNT|PARAMONT|PARAMUNT
PARASAIL|PARASAILING|PARAGLIDE|PARAGLIDING|PARAGLIDER
PARENT|PARENTAL|PARENTE|PARENTEAU|PARENTHOOD|PARENTI|PARENTING|PARENTTEACHER
PARISH|PARISHE|PRISH
PARIS|PARISIAN|PARISIEN|PARISIENNE
PARK|PARKASH|PARKCHESTER|PARKCREST|PARKDALE|PARKE|PARKER|PARKERSBURG|PARKERSON|PARKESBURG|PARKEY|PARKHILL|PARKHURST|PARKIN|PARKING|PARKINSON|PARKLAND|PARKLANE|PARKLAWN|PARKMAN|PARKOUR|PARKPLACE|PARKRIDGE|PARKROSE|PARKSIDE|PARKSTONE|PKY|PARKVIEW|PARKVILLE|PARKWAY|PARKWEST|PARKWOOD|PKWY|PRK|PRKER|PRKG
PARLOR|PARLOUR|PRLOR
PARSON|PARSONAGE
PARTICIPATE|PARTICIA|PARTICIPANT|PARTICIPATING|PARTICIPATION
PARTNER|PARTN|PARTNE|PARTNERING|PARTNERSHIP|PARNERSHIP|PARNT|PARNTER|PARNTERSHIP|PARTNERSH|PARDNER|PARTNERSHI|PARTNERSHP|PARTNERSLLC|PARTNESHIP|PARTNR|PARTNRSHIP|PARTSHP|PARTERSHIP|PRTER|PRTN|PRTNE|PRTNER|PRTNERSH|PRTNERSHI|PRTNERSHIP|PRTNR|PRTNRSH|PRTNRSHI|PRTNRSHIP|PRTNRSHP|PRTR|PTN|PTNR|PTNRSHP|PTNSHP|PTRSHP
PARTY|FIESTA|PARTIE
PATCH|PATCHIN|PATCHING|PATCHWORK|PATCHED
PATHOLOGY|PATHOLOGIST|PTHLOGY|PTHOLOGY
PATROL|PATROLMEN|PTROL
PAVE|PAVEMENT|PAVER|PAVING|PAVEING
PAVILION|PAVILLION
PAWN|PAWNBROKER|PAWNEE|PAWNSHOP
PAY|PAYA|PAYABLE|PAYAL|PAYAM|PAYAN|PAYCHECK|PAYDAY|PAYE|PAYEE|PAYER|PAYETTE|PAYING|PAYLES|PAYMAN|PAYMASTER|PAYMENT|PAYPHONE|PAYROLL|PYMNT|PYROLL|REPAY|REMITTANCE
PEACE|PEACEABLE|PEACEFUL|PEACEMAKER
PEACH|PEACHE|PEACHEY|PEACHSTATE|PEACHTREE|PEACHY
PEDDLE|PEDDLER
PEDIATRIC|PEDIATRC|PDATRIC|PEDIATRICIAN|PEDIATRIX|PEDICAB|PDIATRIC|PDTRIC
PENTECOST|PENTACOSTAL|PENTCSTL|PENTECOASTAL|PENTECOSTAL|PENTECOSTE|PENTECSTAL|PENTECSTL|PENTICOSTAL|PNT|PNTCOSTAL|PNTCSTAL|PNTCSTL|PNTE|PNTECOSTAL
PEOPLE|PPL|PPLE
PERCEPTION|PERCEPTIVE
PERFECT|PERF|PERFECTA|PERFECTED|PERFECTING|PERFECTION|PERFECTIONIST|PERFECTLY|PERFECTO|PRFCTN|PRFECT|PURRFECT|PURRFECTION
PERFORM|PREFORMANCE|PERFORMA|PERFORMACE|PERFORMAN|PERFORMANC|PERFORMANCE|PERFOMANCE|PERFORMER|PERFORMNCE|PERFRMNCE|PROFORMANCE|PRFMCE|PRFRMG|PRFRMNCE|PRFRMNG|HIPERFORMANCE|PERFORMING
PERFUME|PERFUMERIA|PERFUMERY
PERIOD|PERIODICAL|PERIODICO
PERIODONTAL|PERIODONTIC|PERIOPERATIVE
PERMANENT|PERMANENTE|PERMENTER|PRMNT
PERMIT|PERMITTING
PERPETUAL|PERPETUA|PERPETUITY
PERSIA|PERSIAN
PERSIST|PERSISTENT|PERSISTENCE
PERSON|PERSNL|PERSONA|PERSONAL|PERSONALITIE|PERSONALITY|PERSONALIZE|PERSONALIZED|PERSONALLY|PERSONEL|PERSONELL|PERSONIFIED|PERSONLZED|PERSONNAL|PRSNL|PRSNLZED|PRSNNEL|PRSON|PRSONNEL
PERSUASION|PERSSON
PETROCHEMICAL|PETROCHEM
PETROL|PETROLEUM|PETROLIUM
PET|PETSITTER|PETSITTING|PETWAY|PETZ
PHARM|PHARMA|PHARMAC|PHARMACAL|PHARMACARE|PHARMACEUTIC|PHARMACEUTICAL|PHARMACIE|PHARMACIST|PHARMACOLOGY|PHARMACY|PHARMATECH|PHARMD|PHC|PHCY|PHRM|PHRMCUTICAL|FARMA|FARMACIA|FARMACY
PHASE|PHAZE
PHENOM|PHENOMENAL|PHENOMENON
PHIL|PHILA|PHILADELPHIA|PHILADLPHIA|PHLADELPHIA|PHLDELPHIA|PHLDLPHIA|FILADELFIA
PHILANTHROPIC|PHILANTHROPY|PHILATELIC
PHILOSOPHY|PHILOSOPHICAL
PHOENIX|PHNIX
PHONE|PHON|PHONECARD|PHONG|PHONIC|PHONOGRAPH
PHOTGRAPHY|PHOTO|PHOTOART|PHOTOBOOTH|PHOTOG|PHOTOGR|PHOTOGRA|PHOTOGRAHY|PHOTOGRAP|PHOTOGRAPH|PHOTOGRAPHER|PHOTOGRAPHIC|PHOTOGRAPHIE|PHOTOGRAPHY|PHOTOGRAPY|PHOTOGRPAHY|PHOTOGRPHY|PHOTOLAB|PHOTOWORK|PHTGRAPHIC|PHTGRAPHY|PHTGRPHIC|PHTGRPHY|PHTO|PHTOGRAPHIC|PHTOGRAPHY|PICTURE|PICTORIAL|PCTRE|PCTURE|PICTURESQUE|PORTRAIT|PORTRAITURE|PRTRAIT|FOTO|FOTOGRAFIA|FOTOGRAPHY
PORTUGAL|PORTUGESE|PORTUGUESE
POSITION|POSITANO|POSITIONING
PHOTON|PHOTONIC
PHYSIC|PHYSCAL|PHYSCAN|PHYSCIAL|PHYSCIAN|PHYSCL|PHYSCN|PHYSI|PHYSIATRY|PHYSICA|PHYSICAL|PHYSICALLY|PHYSICAN|PHYSICI|PHYSICIA|PHYSICIAN|PHYSICL|PHYSICN|PHYSIO|PHYSIOLOGY|PHYSIOTHERAPY|PHYSIQUE
PIANO|PIANIST
PIERCE|PERCING|PIERCING
PILGRIM|PILGRAM|PILGRIMAGE
PILOT|PILOTING
PIONEER|PIONEERING|PIONR
PIPELINE|PPLINE
PIZZA|PIZZARIA|PIZZERIA|PZZA|PZZERIA|PZZRIA
PLACE|PLA|PLAC|PLACED|PLACEMAT|PLACEMENT|PLACENCIA|PLACENTIA|PLACING|PLCEMENT|PLCMENT|PLCMNT
PLACID|PLACIDA|PLACIDO|PLACITA
PLAN|PLANNING|PLANNER|PLANNED|PLN|PLNNER|PLNNG|PLNG
PLANT|PLANTA|PLANTATION|PLANTE|PLANTED|PLANTER|PLANTING|PLANTSCAPE|PLANTSCAPING|PLANTTION|PLANTZ|PLNT|PLNTN
PLASTER|PLASTERCRAFT|PLASTERER|PLASTERING
PLASTIC|PLASTI|PLST|PLSTC|PLSTIC
PLATE|PLATED|PLATER|PLATING
PLATINUM|PLATINIUM|PLATIUM|PLATNIUM|PLATNUM
PLEASE|PLEASANT|PLASANT|PLEASENT|PLEASER|PLEASING|PLEASURE|PLSANT
PLEAT|PLEATING|PLEATED
PLEDGE|PLEDGER|PLEDGED
PLANET|PLNET
PLUMBER|PLUMB|PLMB|PLMBG|PLMBING|PLMBNG|PLMG|PLUMBG|PLUMBI|PLUMBIN|PLUMBING|PLUMBLINE|PLUMBLING|PLUMBNG|PLUGGED|PLUM|PLUMMER|PLUMMING|PLUMER|PLUMING|REPIPE
PNEUMATIC|PNEUMA
PANHANDLE|PNHDL
PENSION|PNSION|PENSIONER
PONTIAC|PNTIAC
PEANUT|PNUT
PODIATRY|PODIATRIC|PODIATRIST
POEM|POET|POETIC|POETRY|PROSE
POINT|POINTE|POINTED|POINTER|POINTING
POISE|POISED
POISON|POISSON
POLAR|POLARI|POLARITY
POLICE|POLICEMEN|POLICING
POLICY|POLICIE
POLISH|POLISHAMERICAN|POLISHED|POLISHER|POLISHING
POLITIC|POLITI|POLITICAL|PLT|PLTCAL
POLKA|POLKADOT
POLL|POLLING|POLSTER
POLLEN|POLLIN|POLLINATION
POLY|POLYTECHNIC|POLYTECHNICAL|POLYNESIA|POLYNESIAN
POOCH|POOCHE|POOCHIE|POODLE
POOL|POOLE|POOLED|POOLER|POOLING|POOLSIDE
POOP|POOPER
POOR|POORBOY|POORMAN|POBOY
POPULAR|POPULATION|POPULOUS
PORCH|POARCH|PORCHLIGHT
PORK|PORKY
PORSCHE|PORCHE|PORSHA
PORT|PORTA|PORTABLE|PORTAGE|PORTAL|PORTALE|PORTE|PORTELA|PORTELL|PORTICO|PORTO|PORTZ|PORTSIDE|PRTABLE|PRTBLE|SEAPORT
PORTLAND|PDX|PRTLAND
POSITIVE|POSITIVELY|POSITIVITY|POSTIVE|PSTIVE
POSSIBLE|POSSIBILITY|POSSIBILITIE
POST|POSTA|POSTAGE|POSTAL|POSTCARD|POSTER|POSTING|POSTMA|POSTMAN|POSTMASTER|PSTAL|PSTL
POT|POTTED|POTTER|POTTERY|POTTING
POTATO|SPUD|POTATOE
POUND|POUNDER|POUNDING
POUR|POURED|POURING
POWDER|POWDERCOATING|POWDERHORN|POWDR|PWDR
POWER|POWERED|POWERFUL|POWR|PWR|PWER|POWERWASH|POWERWASHING
PRACTICE|PRAC|PRACT|PRACTCAL|PRACTI|PRACTIC|PRACTICAL|PRACTICALLY|PRACTICING|PRACTIONER|PRACTITIONER|PRCTC|PRCTCE|PRCTICE
PRAIRIE|PRAIRE|PRAIRIELAND|PRAIRIEVILLE|PRARIE|PRIRIE|PRRIE
PRAY|PRAYER|PRAYING
PREACH|PREACHER|PREACHING
PRECIOUS|PRECIOU|PRECIADO|PRECIOSA
PRECISE|PRECISELY|PRECISION|PERCISION|PRECISON|PRCES|PRCISION|PRCSION|PREC
PREDICT|PREDICTION|PREDICTIVE
PREFER|PERFERRED|PREFERED|PREFERENCE|PREFERRED|PREFFERED|PRFRRED
PREGNANT|PREGNANCY|PRGNANCY|PRGNNCY
PREMIER|PREMEIR|PREMIERE|PREMIO|PREMIRE|PREMIUM|PREMO|PRMIER|PRMIUM
PREPARE|PREP|PREPARATION|PREPARATORY|PREPARED|PREPAREDNES|PREPARER|PREPARING|PREPERATION|PREPPER|PRPRTORY
PRESBYTERIAN|PRESB|PRESBT|PRESBY|PRESBYTERY|PRESBYTRIAN|PRSBT|PRSBYTRN|PRESBYTER
PRESCHOOL|PRESC|PRESCH|PRESCHL|PRESCHO|PRESCHOO|PRSCHL|PRSCHOOL
PRESCRIPTION|PRESCR|PRESCRIBED|PRESCRIPTIVE
PRESENT|PRESENCE|PRESENTATION|PRESENTER
PRESERVE|PRESER|PRESERV|PRESERVATION|PRESERVATN|PRESERVED|PRESERVER|PRESERVING|PRESERVTN|PRESRVTN|PRSERVATION|PRSERVE|PRSRVATION|PRSRVE|PRSRVTION|PRSRVTN
PRESIDENT|PRESIDENTE|PRESIDENTIAL|PREZ
PRESIDING|PRESIDIO|PRESIDIUM
PRESS|PRESSE|PRESSED|PRESSER|PRESSING|PREPRES|PREPRESS|PRSNG
PRESSURE|PRESSU|PRESSUR|PRESSUREWASHING|PRESURE|PRSSURE
PRESTIGE|PREST|PRESTA|PRESTAGE|PRESTAMO|PRESTI|PRESTIGIOU|PRSTIGE
PRETTY|PRETTI|PRETTIE|PRETTYMAN
PRIUS|PREUS
PREVAIL|PREVAILING
PREVENT|PREVENTATIVE|PREVENTION|PREVENTIVE|PRVENTION|PRVNTION|PRVNTN
PRICE|PRC|PRCE|PRCING|PRICED|PRICELES|PRICING
PRIEST|PRIESTER|PRIESTHOOD|PRIESTLEY|PRIESTLY
PRIME|PRIM|PRIMA|PRIMARY|PRIMARILY|PRIMED|PRIMIER|PRIMO|PRINE|PRMRY
PRIMATE|PRIMATIVE|PRIMAL|PRIMITIVE|PRIMITIVO|PRMTIVE
PRINCE|PRINCES|PRINCESA|PRINCESSE|PRNCE|PRINCIPAL|PRINCIPE|PRINCIPIA|PRINCIPLE|PRINCIPLED
PRINT|PRNT|PRNTING|PRNTNG|PRINTABLE|PRINTED|PRINTER|PRINTERY|PRINTI|PRINTIN|PRINTING|PRINTSHOP|PRINTWEAR|PRINTWORK|PRINTZ|PRTG
PRIORITY|PRIORTY|PRIOR|PRIORE|PRIORITIE
PRISM|PRISMA|PRISMATIC|PRIZM
PRISON|PRISONER
PRISTINE|PRESTINE
PRIVACY|PRIV|PRIVADA|PRIVAT|PRIVATE|PRIVATEER|PRIVE|PRIVETT|PRIVETTE|PRIVILEGE|PRIVILEGED|PRIVTE|PRVATE|PRVT|PRVTE
PROACTIVE|PROACTION
PROBATE|PROBATION
PROBE|PROBITY
PROBLEM|PROBLEMATIC
PROCESS|PROCESSED|PROCES|PROCESSE|PROCESSI|PROCESSIN|PROCESSING|PROCESSOR|PROCE|PROCEDURE|PROCEED|PROC
PROCTOR|PROCTER
PROCURE|PRCOU|PRCRMENT|PROCUREMENT
PRODIGAL|PRODIGIOU|PRODIGY
PRODUCE|PRODUCER|PRODUCING|PRODUCT|PRD|PRDCT|PRODUCTI|PRODUCTIO|PRODUCTION|PRODUCTIONSINC|PRODUCTIONSLLC|PRODUCTIONZ|PRODUCTIVE|PRODUCTIVITY|PRODUCTN|PRODUCTO|PRODUCTSINC|PRODUTION|PRODU|PRODUC|PRODUCCIONE|PROD|PRODCT|PRODCTN|PRODN|PRDCTION|PRDCTN|PRDCTON|PRDUCTION
PROFESSIONAL|PROFFESIONAL|PROFFESSIONAL|PRFESSIONAL|PROFE|PROFECTION|PROFES|PROFESIONAL|PROFESIONALE|PROFESSI|PROFESSINAL|PROFESSIO|PROFESSION|PROFSNL|PROFSSNL|PROFESSIONA|PRFSNL|PRFSSIONAL|PRFSSNAL|PRFSSNL|PRFSSONAL|PROFESSIONALLY|PROFESSIONL|PROFESSNAL|PROFESSNL|PROFESSONAL|PRF|PROFESSOR|PROF|PROFICIENT|PROFICIENCY|PROZ
PROFILE|PROFILING
PROFIT|PRFIT|PROFITABILITY|PROFITABLE|PROFITT|PROFFIT|PROFETA|PROFETICA|PROFETICO|PROFFITT|PROPHET|PROFET|PROPHECY|PROPHETIC
PROGRAM|PROGRA|PGR|PGRM|PROGRAMA|PROGRAMING|PROGRAMME|PROGRAMMED|PROGRAMMER|PROGRAMMING|PROGRM|PROG|PROGESSIVE|PROGR|PRG|PRGM|PRGRAM|PRGRM
PROGRES|PROGRESO|PROGRESSION|PROGRESSIVE|PROGRESSO|PROGRSSIVE|PRGRES|PRGRSSIVE
PROJECT|PROJ|PROJE|PROJEC|PRJ|PRJCT|PRJECT|PROJECTCO|PROJECTION|PROJECTOR|PROJEKT|PROJEX
PROMINENT|PROMINENCE
PROMISE|PRMISE|PROMISED|PROMISELAND|PROMISING
PROMOTE|PROMO|PROM|PROMOCIONE|PROMOT|PROMOTER|PRMOTION|PRMOTIONAL|PRMTONAL|PRMTION|PRMTIONAL|PRMTNAL|PRMTON|PROMOTI|PROMOTING|PROMOTIO|PROMOTION|PROMOTIONAL|PROMOTORA
PROOF|PROOFING|PROOFREADING
PROPAGATION|PROPAGATE
PROPEL|PROPELLER|PROPE
PROPERTY|PROPER|PROPERIE|PROPERITE|PROPERITIE|PROPERT|PROPERTI|PROPERTIE|PROPERTIESINC|PROPERTIESLLC|PROP|PORPERTIE|PROPETIE|PROPETY|PROPPER|PROPR|PROPP|PROPRT|PROPRTIE|PROPRTY|PROPTY|PRP|PRPERTIE|PRPERTY|PRPRT|PRPRTIE|PRPRTY|PRPT|PRPTY|PRTIE|PRTY
PROPRIETOR|PROPRIETARY|PROPRIETORSHIP
PROSECUTE|PROSECUTOR|PROSECUTING
PROSPECT|PROSPECTING|PROSPECTIVE|PROSPECTOR
PROSPER|PROSPERA|PROSPERITY|PROSPERO|PROSPEROU|PROSPORT|PROSPRITY
PROTECT|PROT|PROTCTN|PROTE|PROTECTED|PROTECTI|PROTECTING|PROTECTIO|PROTECTION|PROTECTIVE|PROTECTN|PROTECTOR|PROTEC|PRTCTION|PRTCTIVE|PRTCTN|PRTECTION|PRTECTIVE
PROTEIN|PROTEAN
PROTO|PROTOCOL|PROTOTYPE|PROTOTYPING|PROTON
PROVE|PROVEN|PROVENANCE|PROVENCAL|PROVENCE|PROVING|PROVISION|PROVISIONAL|PROVISIONING
PROVIDE|PROVI|PROVIDED|PROVIDENCE|PROVIDENCIA|PROVIDENT|PROVIDENTIAL|PROVIDER|PROVIDIAN|PROVIDING|PROVIDNCE|PROVINCE|PROVINCIAL|PRVDNCE|PRV|PRVDER|PRVIDER
PROXIMITY|PROXIMA
PROPANE|PRPN
PROSTHETIC|PRSTHETIC|PRSTHTIC
PORTFOLIO|PRTFLIO|PRTFOLIO
PRUDENT|PRU|PRUDE|PRUDEN|PRUDENCE|PRUDENCIO|PRUDENTIAL
PRUNE|PRUNING
PSYCH|PSYCHATRIC|PSYC|PSYCHE|PSYCHEDELIC|PSYCHIATRIC|PSYCHIATRIST|PSYCHIATRY|PSYCHIC|PSYCHL|PSYCHLGCAL|PSYCHLGCL|PSYCHLGICAL|PSYCHLGIST|PSYCHLGST|PSYCHLOGICAL|PSYCHLOGIST|PSYCHLOGY|PSYCHO|PSYCHOANALYTIC|PSYCHOEDUCATIONAL|PSYCHOL|PSYCHOLO|PSYCHOLOG|PSYCHOLOGI|PSYCHOLOGICAL|PSYCHOLOGIST|PSYCHOLOGY|PSYCHOSOCIAL|PSYCHOTHERAPIST|PSYCHOTHERAPY|PSYCHTHERAPY|PSYCHTHRAPY|PSYCHTHRPY|PSYCHTRC|PSYCHTRIC|PSYCHTRY
PATIENT|PTIENT|INPATIENT
PUBLIC|PUBL|PUBLC|PUBLI|PBLC|PUBLICA|PUBLICATION|PBLCATION|PBLCTION|PBLCTON|PBLIC|PBLICATION|PUBLICIDAD|PUBLICITY|PUBLISH|PUBLISHED|PUBLISHER|PUBLISHI|PUBLISHIN|PUBLISHING|PUBG
PULMONARY|PULMONOLOGY|PLMNARY
PULP|PULPWOOD
PULSE|PULSAR|PULSIFER
PUMP|PUMPER|PUMPIN|PUMPING|PUMPED
PURCHASE|PURCH|PRCH|PURCHASER|PURCHASING
PURE|PURELY|PURI|PURIFICATION|PURIFIED|PURIFIER|PURIFOY|PURIFY|PURITY
PURITAN|PURINTON|PURITA
PURPOSE|PRPOSE|PURPOSED|PURPOSEFUL
PURSE|PURSER
PURSUE|PURSUING|PURSUIT
PURVEYOR|PURVE
PUSH|PUSHER|PUSHING
PUTT|PUTTER|PUTTIN|PUTTING
PYROTECHNIC|PYRO
PIZAZZ|PIZZAZ|PIZZAZZ|PZAZZ
QUA|QUACH|QUACK|QUACKENBUSH|QUACKER|QUAKER|QUAKE|QUAKERTOWN
QUALITY|QUAILITY|QUAILTY|QUAL|QUALE|QUALI|QUALIFIED|QUALITA|QUALITATIVE|QUALITECH|QUALL|QUALTIY|QUALTY|QL|QLITY|QLTY|QULTY
QUANT|QUANTA|QUANTICO|QUANTITATIVE|QUANTITY|QUANTUM
QUARRY|QUARRIE|QUARRYVILLE
QUART|QUARTER|QUARTERBACK|QUARTERDECK|QUARTERHORSE|QRTER|QTR|QUATER|QUARTERLY|QUARTERMAN|QUARTERMASTER
QUEBEC|QUEBECOR|QUEBEDEAUX|QUEBECOIS|QUEBECOISE
QUEEN|QUEENIE|QEEN|QUEENSBORO|QUEENSBURY|QUEENSTOWN|QUEENZ|QUESENBERRY
QUEST|QUESTA|QUESTAR|QUESTER|QUESTION|QWEST|QEST
QUICK|QUICKBOOK|QUICKER|QUICKIE|QUICKLY|QUICKMART|QUICKPRINT|QUICKSILVER|QUICKSTOP|QUICKWAY|QUICKY|QUIK|QUIKTRIP|QWIK|KWIK|KWICK|KWIKTRIP
QUILT|QUILTED|QUILTER|QUILTING|QUILTWORK|QUILTY
QUINT|QUINTA|QUINTAL|QUINTANA|QUINTANAR|QUINTANILLA|QUINTEN|QUINTER|QUINTERO|QUINTESSENCE|QUINTESSENTIAL|QUINTIN|QUINTO|QUINTON
QUIRK|QUIRKY
RACE|RACECAR|RACELAND|RACER|RACETRACK|RACEWAY|RACEY|RACIAL|RACIN|RACING|RACY|RACZ
RACK|RACKER|RACKET|RACKING|RACQUET|RACQUETBALL|RAQUET
RADI|RADIAL|RADIAN|RADIANCE|RADIANT|RADIATION|RADIATOR
RADIO|RADIOACTIVE|RADIOGRAPHIC|RADIOLOGIC|RADIOLOGICAL|RADIOLOGIST|RADIOLOGY|RADIOSHACK|RADIU|RADIUM|RDLGY
RAG|RAGAN|RAGGED|RAGGEDY|RAGTIME|RAGZ
RAGE|RAGEN|RAGER|RAGIN|RAGING
RAID|RAIDER
RAIL|RAILCAR|RAILEY|RAILHEAD|RAILING|RAILROAD|RAILROADER|RAILSBACK|RAILSIDE|RAILWAY|RAILYARD|RAYL|RLWY
RAIN|RAINA|RAINBO|RAINBOLT|RAINBOW|RAINCROS|RAINDANCE|RAINDROP|RAINE|RAINFORD|RAINFOREST|RAINGUTTER|RAINIER|RAINING|RAINMAKER|RAINMAN|RAINSOFT|RAINSVILLE|RAINTREE|RAINVILLE|RAINWATER|RAINY
RAKE|RAKER|RAKING
RAMBLE|RAMBLER|RAMBLEWOOD|RAMBLIN|RAMBLING
RAMP|RAMPAGE|RAMPANT|RAMPART
RANCH|RANCHER|RANCHERIA|RANCHERO|RANCHETTE|RANCHING|RANCHITO|RANCHLAND|RANCHO|RNCH|RNCHO
RANGE|RANGELAND|RANGELINE|RANGER|RNG|RNGE
RANK|RANKIN|RANKING|RANKED
RAPID|RAPIDAN|RAPIDE|RAPIDO
RARE|RARITAN|RARITIE|RARITY|RARER
RATE|RATED|RATER|RATING
RATIO|RATION|RATIONAL
RATTLE|RATTLER|RATTLESNAKE
RAW|RAWHIDE
RAY|RAYO|RAYZ
RAZOR|RAYZOR|RAZO|RAZORBACK
RAZZ|RAZZANO|RAZZLE|RAZZIE
REACH|REACHING|REACHOUT
REACT|REACTION|REACTIVE|REACTOR
READ|READE|READER|READING
READY|READINES|READI|READYMIX
REAL ESTATE|REALATOR|RELATY|REALTY|REALSTATE|REALT|REALTIE|REALTO|REALTYCOM|REALTYINC|REALTYLLC|REMAX|RLITY|RLTOR|RLTR|REALTOR|RLTY|REALESTATE
REAL|REALCO|REALE|REALI|REALIFE|REALIST|REALISTIC|REALITY|REALITIE|REALIZATION|REALIZE|REALIZED|REALLY|REALTIME|REALVEST|REALY
REAM|REAME|REAMER|REAMED|REAMING
REAP|REAPER|REAPING|REAPED
REBEL|REBELLION|REBELLIOU|REBELLO
REBOOT|REBORN|REBOUND
RECEIVE|RECEIVABLE|RCVBLE|RECEIVER|RECEIVERSHIP|RECEIVING|RECEPTION|RECEPTIVE|RECIEVE|RECIEVABLE|RECIEVER|RECIEVERSHIP|RECIEVING
RECES|RECESSION|RECESSED
RECLAIM|RECLAIMED|RECLAIMING|RECLAMATION
RECON|RECONNAISSANCE|RECOGNITION|RECOGNIZE|RECOGNIZED
RECONDITION|RECONDITIONED|RECONDITIONING
RECORD|RECOR|RCRDING|RCORD|RCORDING|RECORDED|RECORDER|RECORDING|RECORDZ
RECOVER|RECOV|RECOVE|RCVERY|RCVRY|RECOVERED|RECOVERIE|RECOVERING|RECOVERY|RCOVERY|RECOVRY|RECVRY|REVOCER|REVOCERY
REC|RECREAT|RECREATE|RECREATION|RECREATIONAL|RCRATION|RCREATION|RECREATN|RECR
RECRUIT|RECRTL|RCRITING|RCRTER|RCRTING|RCRTION|RCRTL|RCRTN|RCRUITER|RCRUITING|RECRUITER|RECRUITING|RECRUITMENT|RECRUTING
RECTANGLE|RECTANGULAR
RECTOR|RECTORY
RECYCLE|RECY|RECYCL|RECYCLABLE|RCYCL|RECYCLED|RECYCLER|RECYCLING|RECYLING|REUSE|REUS|REUSABLE|RNEWABLE
REDEEM|REDEEMED|REDEEMER|REDEEMING|REDEMPTION|REDEMPTIVE
REDEFINE|REDEFINED|REDEFINING
REDESIGN|REDESIGNED
REBUILD|REBUILDER|REBUILDING|REBUILT|REDEVELOPER|REDEV|RDVELOPMENT|RDVLOPMENT|RDVLPMENT|RDEVELOPMENT|REDEVELOPMENT
REDUCE|REDUCTION|RDTION|RDCTN|REDUX|REDUCED
REED|REEDY
REEF|REEFER
REF|REFER|REFERAL|REFERRED|REFERRAL|REFF|REFFERAL|REFERENCE|RFERRAL|RFR|RFRRAL|REFERREE|REFFEREE|REFEREE
REFINANCE|REFI|REFIN|REFINAINCING|REFINANCED|REFINANCER
REFINE|REFINED|REFINEMENT|REFINER|REFINERY|REFINI|REFINING|RFNG|REFINISH|REFINISHER|REFINISHING|RFINISHING|RFNISHING|RFNSHING|REFURNISH|REFURNISHED|REFURNISHING|REFURB|REFURBISHED|REFURBISHING
REFLECT|REFLECTING|REFLECTION|REFLECTIVE|REFLECTON|REFLEXION|RFLCTION|RFLCTON
REFLEX|REFLEXOLOGY
REFORM|REFORMATION|REFORMED|RFRMED|REFORMING
REFRACT|REFRACTIVE|REFR|REFRACTORIE|REFRACTORY|REFRACTION
REFRESH|REFRESHED|REFRESHING|REFRESHMENT|REFRESQUERIA
REFUGE|REFUGEE|REFUGIO|RFUGE
REFUND|REBATE|REFUNDING|REFUNDED
REGAL|REGALADO|REGALIA|REGALO|REGALED|REGALING
REGEN|REGENERATION|REGENA|REGENERATIVE
REGIME|REGIMENT|REGIMENTAL|REGIMENTED
REGION|REGINAL|REGIONAL|REGN|REGNL|REGL|RGIONAL|RGNAL|RGNL|RGONAL
REGISTER|REGESTER|REGISTERED|REGISTRAR|REGISTRATION|REGISTRY|RGSTRED|RGSTRY
REGULAR|REGU|REGULA|REGULATION|REGULATOR|REGULATORY|REGULU|RGL|RGLTORY
REHAB|REH|REHA|REHABBER|REHABCARE|REHABI|REHABIL|REHABILATION|REHABILI|REHABILIATION|REHABILIT|REHABILITA|REHABILITAION|REHABILITAT|REHABILITATI|REHABILITATIO|REHABILITATION|REHABILITATIVE|REHABILITION|REHABLITATION|REHABLTTION|RHB|RHAB|RHABILITATION|RHBILITATION|RHBLITATION|RHBLTATION|RHBLTTION|RHBLTTN
REINFORCED|REINFORCEMENT|REINFORCING
REJOICE|REJ|REJOYCE|REJOICED|REJOICING
REJUVENATE|REJUV|REJUVENATING|REJUVENATION|REJUVINATION|REJUVENATED
RELATE|REL|RELA|RELAT|RELATED|RELATION|RELATIONAL|RELATIONSHIP|RELATIVE|RLATION|RLTION|RLTN|RLTON
RELAX|RELAXATION|RELAXED|RELAXING
RELEASE|RELEASED|RELEASING
RELEVANT|RELEVANCE
RELY|RELIABLE|RELI|RELIABILITY|RELIANCE|RELIANT|RLBLE
RELIGION|RELIGIOU|RELIGOU|RLGIOU|RLGOU|RLIGIOU
RELOAD|RELOADED|RELOADING
REMAIN|REMAINDER|REMNANT|REMANENTE
REMARK|REMARKABLE
REMEDIAL|REMEDIATION|REMEDIATE
REMEDY|REMEDIE|REMEDIO
REMEMBER|RECALL|RECAP|RECAPPING|REMEMBERED|REMEMBERING|REMEMBRANCE|RECOLLECTION
REMODEL|REMOD|REMODE|REMODELATION|REMODELER|REMODELI|REMODELIN|REMODELING|REMODELED|REMODELLING|REMODELNG|REMODLEING|REMODLER|REMODLING|REMOLDELING|REMOLDING|RENNOVATION|RENOVATE|RENOVATED|RENOVATI|RENOVATING|RENOVATIO|RENOVATION|RENOVATOR|RENOVO|RMDLG|RMDLNG|RNOVATION|RNVATION|RNVTION|RNVTON
REMOVE|REMOV|REMOVA|REMOVABLE|REMOVAL|REMOVEL|REMOVER|RMOVAL|RMV|RMVAL|RMVL
RENAISSANCE|RENAISSNCE|RNAISSANCE|RNSSNCE
REND|RENDER|RENDERED|RENDERING|RENDITION|RENDED
RENEW|RENEWABLE|RENEWAL|RENEWBLE|RENEWED|RENEWING|RNEWAL|RNW|RNWABLE|RNWAL|RNWBLE
RENOWN|RENOWNED
RENT|RENTED|RENTA|RENTACAR|RENTAL|RENTALL|RENTER|RENTERIA|RENTING|RENTL|RENTZ|RNT|RNTAL|RNTL
REPAIR|REPAIRE|REPAIRER|REPAIRING|REPAIRMAN|REPARATION|REAPIR
REPEAT|REPEATER|REPETITION|REPETITIVE
REPERTORY|REPERTOIRE
REPLACE|REPLACEMENT|RPL|RPLACEMENT|RPLCEMENT|RPLCMENT
REPLICA|REPLICATION
REPORT|REPORTER|REPORTING|RPORTING|RPRTING|RPT
REPOSE|REPOSITORY|REPOSTERIA
REPO|REPOSSESSION
REPRESENT|REPR|REPRE|REPRESENTACIONE|REPRESENTATION|REPRESENTATIVE|REPRESENTING|RPRESENTATIVE|RPRSENTATIVE|RPRSNTATIVE|RPRSNTTIVE
REPRO|REPRODUCTION|REPRODUCTIVE|REPROGRAPHIC
REPUBLIC|REPUB|REPUBLICA|REPUBLICAN
REPUTE|REPUTABLE|REPUTATION
REQUIRE|REQUIRED|REQUIREMENT
RESCUE|RESCU|RESCUED|RESCUER|RESQ|RSCUE
RESEARCH|RESEA|RESEACH|RESEAR|RESEARC|RESEARCHER|RESERCH|RESER|RESRCH|RSCH|RSEARCH|RSRCH|RSRC
RESERVE|RESERV|RESERVATION|RESERVED|RSERVE|RSRVE
RESIDENCE|RESI|RESID|RESIDE|RESIDEN|RESENDE|RESENDEZ|RESENDIZ|RESDNTL|RESIDENCIAL|RESIDENCY|RESIDENT|RESIDENTAIL|RESIDENTAL|RESIDENTIAL|RESIDNTIAL|RSD|RSDENT|RSDENTIAL|RSDNCE|RSDNT|RSDNTIAL|RSDNTL|RSIDENCE|RSIDENT|RSIDENTIAL
RESIDUE|RESIDUAL|RESIDUARY
RESILIENT|RESILIENCE|RESILIENCY
RESIST|RESISTING|RESISTED|RESISTANCE|RESISTANT
RESOLVE|RESOLUTION|RSOLUTION|RSLTION|RSLUTION|RESOLVED|RESOLVING
RESONANT|RESONANCE|RESONATE|RESOR
RESOURCE|RESOU|RESOUCE|RESOUR|RESOURC|RESORCE|RESOURCEFUL|RESOURCING|RESOURE|RESOURSE|RESRC|RESRCE|RSOURCE|RSRCE|RSURCE
RESPECT|RESP|RESPECTABLE|RESPECTFUL
RESPOND|RESPON|RESPONDER|RESPONSE|RESPONSIBILITY|RESPONSIBLE|RESPONSIVE|RSPNSBLE|RSPNSE|RSPONSE
REST|RESTA|RESTARANT|RESTARAUNT|RESTART|RESTARUANT|RESTATED|RESTAU|RESTAUR|RESTAURA|RESTAURACION|RESTAURAN|RESTAURANDO|RESTAURANT|RESTAURANTE|RESTAURATION|RESTAURNT|RESTERAUNT|RESTORANTE|RESTR|RESTRAINT|RESTRAUNT|RESTRAURANT|RESTREPO|RESTRNT|RESTUARANT|RESTURANT|RESTURAUNT|RETAURANT|RSTR|RSTRANT|RSTRNT|RSTRNTE|RESTER|RESTFUL|RESTING|RESTED
RESTORE|RESTORATION|RESTORATI|RESTORATIO|RESTORATIVE|RESTORATN|RESORATION|RESTORED|RESTORER|RESTORING|RESTORTION|RESTORTN|RSTRATION|RSTORATION|RSTRTION|RSTRTN|RSTRTON
RESTYLE|RESTYLING|RESTYLED
RESURFACE|RESURFACING
RESURGE|RESURGENCE|RESURGEN|RESURGENT|RESURGENCY
RESURRECT|RESURRECTION|RESURRECTED|RESURRCTION
RETAIL|RET|RETA|RETAILER|RETAILING
RETARDATION|RETARD|RETARDED|RTRD|RTRDED
RETINA|RETINAL
RETIRE|RETIRED|RETIREE|RETIREMENT|RETIRMENT|RTIREMENT|RTRED|RTREMENT|RTRMENT|RTRMNT
RETOUCH|RETOUCHING
RETRACT|RETRACTION|RETRACTABLE
RETRIEVE|RETRIEVAL|RETRIEVER|RETRIEVING|RETREIVE|RETREIVAL|RETREIVER|RETREIVING
REVEAL|REVEALED|REVEALING|REVELATION
REV|REVERE|REVER|REVEREND|REVERIE|REVERENCE
REVIEW|REVILLA|REVISITED|REVISIT|REVUE
REVIVE|REVITALIZE|REVITALIZATION|REVITALIZING|REVIVAL|REVIVED|REVIVING
REVOKE|REVOCATION|REVOCABLE|REVOC|REVOCAB|REVOCABL|RVOCABLE
REVOLT|REVOLUTION|REVOLUTIONARY
REVOLVE|REVOLVER|REVOLVING
REWARD|REWARDING|REWARDED
RHYME|RHYMER|RHYMING|RHYMED
RHINO|RHYNO|RHINOCEROS
RHYTHM|RHYTHMIC|RYTHM
RIDE|RIDER|RIDERZ|RIDESHARE|RIDEZ|RIDIN|RIDING|RDING
RIDGE|RDGE|RIDGELINE
RIG|RIGGER|RIGGI|RIGGIN|RIGGING|RIGGED
RIGHT|RGHT|RITE|RITEWAY|RIGHTEOU|RIGHTEOUSNES
RING|RINGER|RINGED|RINGING
RIPE|RIPER|RIPEN|RIPENER|RIPENED|RIPENING
RISE|RISING|RSING|RAISE|RAISED|RAISER|RAISIN|RAISING|RISEN
RISK|RISKY|RISKED|RISKING
RITUAL|RITU
RITZ|RITZY
RIVAL|RIVALRY
ROAM|ROAMER|ROAMIN|ROAMING
ROAR|ROARING
ROAST|ROASTED|ROASTER|ROASTERY|ROASTING
ROCK|ROCKABILLY|ROCKEY|ROCKIE|ROCKIN|ROCKING|ROCKN|ROCKNROLL|ROCKY
ROCKET|ROCKETRY|ROCKETT|ROCKIT
ROLL|ROLING|ROLLED|ROLLER|ROLLIN|ROLLING|ROLE
ROMANIA|ROMANIAN
ROME|ROMA|ROMAN|ROMANA|ROMANCE|ROMANCING|ROMANTIC
ROOF|ROOFER|ROOFG|ROOFI|ROOFIN|ROOFING|ROOFNG|ROOFTOP
ROOK|ROOKIE
ROOM|ROOMING|ROOMMATE
ROOT|ROOTED|ROOTER|ROOTZ|ROOTING
ROPE|ROPER|ROPING
ROT|ROTA|ROTAN|ROTARY|ROTATING|ROTATION|RTARY|ROTTING|ROTATE
ROTOR|ROTORCRAFT|ROTOROOTER
ROUTE|ROUTER|ROUTING
ROVE|ROVER|ROVIN|ROVING
ROYAL|REIGN|REIGNING|REGENT|REGENCY|ROYALE|ROYALL|ROYALTIE|ROYALTON|ROYALTY
RESORT|RSORT|RSRT
RUGBY|RGB|RGBY
RULE|RULER|RULING|RULED
RUSH|RUSHER|RUSHIN|RUSHING
RUST|RUSTAD|RUSTED|RUSTPROOFING|RUSTY
RUSTIC|RUSTICA|RUSTICO|RUSTIQUE
SACRAMENT|SACRA
SACRAMENTO|SACRAMNTO|SACREMENTO|SCRMNTO
SACRED|SACRIFICE|SACRIFICIAL
SADDLE|SADDLER|SADDLERY
SAFE|SAFECO|SAFEGUARD|SAFEHAVEN|SAFEHOUSE|SAFELY|SAFER|SAFET|SAFETY|SAFETYNET|SAFTEY|SAFTY|SFETY|SFTY
SAGE|SAGEBRUSH|SAGEWOOD
SAIL|SAILBOARD|SAILBOAT|SAILER|SAILFISH|SAILING|SAILMAKER|SAILOR
SALVATION|SALV|SALVA|SALVACION|SALVADOR|SALVADORE|SALVADORENA|SALVADORENO
SALVAGE|SALVAGED|SALVAGING
SAME|SAMEDAY
SAMPLE|SAMP|SAMPLER|SAMPLEY|SAMPLING
SANCTUARY|SANCTARY|SANCTIFIED|SANCTU|SANCTUM|SANTUARIO|SANTUARY|SNCTARY|SNCTUARY
SAND|SANDAHL|SANDAL|SANDALWOOD|SANDBAR|SANDBLAST|SANDBLASTING|SANDBOX|SANDIN|SANDING|SANDLES|SANDLOT|SANDMAN|SNDBLST|SNDER|SNDY
SANDWICH|SANDWHICH|SANDWICHE|SNDWICH|HOAGIE|SANDWITCH
SANE|SANER|SANITY
SANITARY|SANI|SANILAC|SANITA|SANITARIUM|SANITATION|SANITIZING
SATELLITE|SATELITE|SATCOM|SATE|SATELITTE|SATTELITE|STL|STLLITE
SATISFY|SATISFIED|SATISFACTION
SAUCE|SAUCEDA|SAUCEDO|SAUCER|SAUCIER|SAUCY
SAUD|SAUDI|SAADIA|SADIA|SAUDIARABIA|SAUDIARABIAN
SAVE|SAVEALOT|SAVED|SAVELL|SAVEMORE|SAVEON|SAVER|SAVERIO|SAVERY|SAVEWAY|SAVING|SAVMOR
SAVIOR|SAVIO|SAVIOUR
SAVOR|SAVORY|SAVOUR|SAVOURY
SAW|SAWDUST|SAWMILL|SAWMILLING
SCAFFOLD|SCAFFOLDING
SCANDINAVIA|SCANDIA|SCANDINAVIAN
SCAN|SCANNER|SCANNING
SCATTER|SCATTERED
SCENE|SCENARIO|SCENERY|SCENIC
SCENT|SCENTED|SCENTSY
SCEPTER|SCEPTRE
SCHEDULE|SCHEDULING|SCHEDULED
SCHOOL|SCHOL|SCHOLA|SCHOLAR|SCHOLARLY|SCHOLARSH|SCHOLARSHI|SCHOLARSHIP|SCHOLARSHP|SCHOLASTIC|SCHOLRSHP|SCHLR|SCHLRSHIP|SCHLRSHP|SCHOOLCRAFT|SCHOOLER|SCHOOLHOUSE|SCHOOLING|HIGHSCHOOL|HOMESCHOOL|HOMESCHOOLER|SCHL
SCIENCE|SCI|SCIE|SCIEN|SCIENC|SCIENTFIC|SCENTIFIC|SCIENTIA|SCIENTIFIC|SCIENTIST|SCIFI|SCITECH|SCNCE|SCNTFIC|SCNTIFIC
SCIENTOLOGY|SCIENTOLOGIST
SCISSOR|SCISSORTAIL|SCIZZOR
SCOOP|SCOOPER
SCOOT|SCOOTER
SCOPE|SCOPING
SCORE|SCOREBOARD|SCORING|SCORED
SCORP|SCORPIO|SCORPION
SCOT|SCOTCH|SCOTIA|SCOTLAND|SCOTSMAN|SCOTTI|SCOTTIE|SCOTTISH|SCOTTLAND|SCOTTY
SCOUT|SCOUTING
SCRAP|SCRAPBOOK|SCRAPBOOKING|SCRAPPING|SCRAPPIN|SCRAPPY
SCRAPE|SCRAPER|SCRAPING|SCRAPPER|SCRAPED
SCREAM|SCREAMER|SCREAMIN|SCREAMING|SCREAMED
SCREEN|SCREENER|SCREENING|SCREENPRINT|SCREENPRINTING|SCRENING|SCRN|SCRNING|RESCREEN|RESCREENING
SCRIBE|SCRIBBLE
SCRIPT|SCRIPTURE
SCRUB|SCRUBBER|SCRUBBING|SCRUBBY
SCULPT|SCULPTED|SCULPTING|SCULPTOR|SCULPTURE|SCULPTURED
SEAL|SEALED|SEALING|SEALANT
SEARCH|SEARCHE|SEARCHER|SEARCHING|SEARCHLIGHT|SCHLICHT|SCHLICHTING
SEASON|SEASN|SEASONAL|SEASONED|SEASONING
SEAT|SEATING|SEATER|SEATED
SECRETARY|SCRITIE|SECRETARIAL|SCRETARIAL|SECRETARIAT|SECRETARIE|SECRTY|SCRTARIAL|SCRTRIAL|SCRTIE
SECTION|SECT|SECTOR|SCTION
SECURE|SECU|SECUR|SECURED|SECURI|SECURING|SECURIT|SECURITA|SECURITE|SECURITIE|SECURITIZATION|SECURITY|SECURTIE|SECURTIY|SECURTY|SECURU|SCRTY|SCTY|SCURITIE|SCURLOCK|SERCURITY|SENTINAL|SENTINEL|SENTRY
SEED|SEEDING|SEEDLING|SEEDED
SEEK|SEEKER|SEEKING
SELECT|SELECTA|SELECTED|SELECTION|SELECTIVE|SELECTO|SELECTOR|SLECT
SELF|SELFDEFENSE|SELFDIRECTED|SELFHELP|SELFIE|SELFRIDGE|SELFSERVE|SELFSERVICE|SELFSTORAGE|THYSELF
SEMICONDUCTOR|SEMICDTR|SEMICONDUCTING|SEMICONDUCTION
SEMINARY|SEMINAR|SEMINARIO|SEMINAL|SEMEN
SEND|SENDER|SENDING|SENT|SND
SENSE|SENSATION|SCENTSATION|SCENTSATIONAL|SATION|SATIONAL|SENSATIONAL|SENSEI|SENSENIG|SENSI|SENSIBLE|SENSING|SENSITIVE|SENSOR|SENSORY|SUNSATION|SUNSATIONAL
SENTIMENT|SENTIMENTAL
SEPARATE|SEPARATED|SEPARATION|SEPARATOR
SEQUEL|SEQUENCE|SEQUENTIAL
SERGEANT|SARGEANT|SARGE|SARGENT|SERGENT
SERIOUS|SERIOUSLY|SRSLY
SERPENT|SERPENTINE
SERVE|SERVICE|SERIVCE|SERIVE|SERIVICE|SERV|SERVALL|SERVANDO|SERVANT|SERVC|SERVCE|SERVCIE|SERVCO|SERVED|SERVER|SERVI|SERVIC|SERVICECENTER|SERVICEINC|SERVICELLC|SERVICEMASTER|SERVICEMEN|SERVICENTER|ESERVER|SERVICER|SERVICES|SERVICESCOM|SERVICESINC|SERVICESLLC|SERVICIO|SERVICMSTER|SERVICO|SERVIE|SERVIN|SERVING|SERVISE|SERVO|SERVPRO|SERVU|SREVICE|SRVI|SRVIC|SRVICE|SRV|SRVC|SRVCE|SRVCIO|SRVE|TELESERVICE|SERVICING|SVC
SETTLE|SETTLEMENT|SETTLER|STTER|STTING|STTLE|STTLEMENT|STTLMENT|SETTLED|SETTLING
SEW|SEWING|SEWN
SEWER|SEWERAGE|SPTIC|SEPTIC
SEX|SEXUAL|SEXUALITY|SEXY|SENSUAL|SCENTUAL|SENSUOU
SHAPE|SHAP|SHAPED|SHAPER|SHAPING|SHAPELY
SHARE|SHARED|SHAREHOLDER|SHARER|SHARING
SHARP|SHARPEN|SHARPENING|SHARPER
SHAVE|SHAVED|SHAVER|SHAVING
SHEAR|SHEARER|SHEARIN|SHEARING|SHEARMAN|SHEER
SHEET|SHEETING|SHEETMETAL|SHEETROCK|SHEETZ|SHT|SHTING|SHTMTL
SHELF|SHELVE|SHELVING
SHELTER|SHELTERED|SHELTERING
SHINE|SHINER|SHINEY|SHINING
SHINGLE|SHINGLER|SHINGLED
SHIP|SHIPBUILDING|SHIPG|SHIPMENT|SHIPPER|SHIPPING|SHIPWRIGHT|SHIPYARD|SHP|SHPHERD|SHPPE|SHIPSHAPE
SHOE|SHOEBOX|SHOEING|SHOEMAKE|SHOEMAKER|SHOESTRING|BOOT|BOOTERY
SHOP|SHOPCOM|SHOPE|SHOPPE|SHOPPEE|SHOPPER|SHOPPETTE|SHOPPING|SHOPRITE
SHORE|SHORELINE|SHORESIDE|SHOREVIEW|SHOREWAY|SHOREWOOD|SHORING
SHORT|SHORTCUT|SHORTER|SHORTHAND|SHORTTERM|SHORTY|SHRT
SHOT|SHOOT|SHOOTER|SHOOTIN|SHOOTING|SHOOTOUT
SHOW|SHOWBIZ|SHOWBOAT|SHOWCASE|SHOWDOWN|SHOWER|SHOWGIRL|SHOWING|SHOWMAN|SHOWME|SHOWN|SHOWOFF|SHOWPLACE|SHOWROOM|SHOWSTOPPER|SHOWTIME
SHRED|SHREDDER|SHREDDING
SHUFFLE|SHUFFLEBOARD
SHUT|SHUTTER|SHTTER
SHUTTLE|SHTTLE
SIDE|SIDECAR|SIDEKICK|SIDELINE|SIDER|SIDESHOW|SIDETRACK|SIDEWALK|SIDEWAY|SIDEWINDER|SIDING|SDING
SIGHT|SIGHTLINE|SIGHTSEEING
SIGN|SIGNA|SIGNAGE|SIGNAL|SIGNALING|SIGNARAMA|SIGNING|SIGNED|SIGNATURE|SGNATURE|SGNTURE|SIGNE|SIGNER
SILKSCREEN|SILKSCREENING
SIMPLE|SIMPLEE|SIMPLER|SIMPLEX|SIMPLI|SIMPLICITY|SIMPLIFIED|SIMPLIFY|SIMPLISTIC|SIMPLY
SIMULATE|SIMULATED|SIMULATION|SIMULATOR
SINCERE|SINCERELY|SINCERITY
SIN|SINFUL|SINFULLY|SINNED|SINNING
SING|SANG|SINGING|SONG|SONGBIRD|SONGWRITER|SINGER
SINK|SINKER|SINKING|SANK|SUNK|SUNKEN
SIS|SISTER|SISTERHOOD|SISTERLY|SISTO|SISTR|SSTER
SITE|SITESTUFF|SITEWORK
SITUATION|SCITUATE|SITU
SIZE|SIZED|SIZER|SIZING
SIZZLE|SIZZLER|SIZZLIN|SIZZLING
SKATE|SKATEBOARD|SKATEBOARDING|SKATELAND|SKATEPARK|SKATER|SKATESHOP|SKATING
SKI|SKIER|SKIING|SKIIER
SKILL|SKILLED|SKILLFUL|SKILLZ|SKLL
SKIN|SKINCARE|SKINZ|SKNCARE|SKN
SKIP|SKIPJACK|SKIPPACK|SKIPPER|SKIPPING
SKIRT|SKIRTING
SKY|SKYBLUE|SKYBOX|SKYBRIDGE|SKYDIVE|SKYDIVING|SKYE|SKYHAWK|SKYHIGH|SKYHOUSE|SKYLAKE|SKYLAND|SKYLANE|SKYLAR|SKYLARK|SKYLIGHT|SKYLINE|SKYLINER|SKYLINK|SKYLITE|SKYNET|SKYPARK|SKYRIDGE|SKYROCKET|SKYSCRAPER|SKYTECH|SKYTOP|SKYVIEW|SKYWALKER|SKYWARD|SKYWAY|SKYY
SLACK|SLACKER|SLACKING|SLACKED|SLACKLINE|SLACKLINING
SLAUGHTER|SLAUGHTERHOUSE|SLAUGHTERING
SLED|SLEDGE|SLEIGH|SLEDGEHAMMER
SLEEP|SLEEPER|SLEEPING|SLEEPLES|SLEEPY|SLEPT
SLICE|SLICER|SLICED|SLICING
SLICK|SLICKER
SLID|SLIDE|SLIDER|SLIDING
SLIGHT|SLIGHTLY
SLIM|SLIMMER|SLIMMING
SLING|SLINGER|SLINGSHOT|SLINGING|SLUNG
SLIP|SLIPCOVER|SLIPPER|SLIPPERY|SLIPSTREAM|SLIPPED|SLIPPING
SLUG|SLUGGER|SLUGGISH
SLUSH|SLUSHER|SLUSHY
SMART|SMARTECH|SMARTER|SMARTHOME|SMARTPHONE|SMARTSTYLE|SMARTT|SMARTWAY|SMARTY|SMRT
SMASH|SMASHBURGER|SMASHING|SMATHER|SMASHED|SMASHER
SMELL|SMELLY
SMELTER|SMELTING|SMELTZER|SMELT
SMILE|SMILEY|SMILIN|SMILING|SMILED
SMITH|SMITHER|SMITHEY|SMITHING|SMITHY|SMTH
SMOKE|SMOKED|SMOKEHOUSE|SMOKELES|SMOKEN|SMOKER|SMOKESHOP|SMOKETREE|SMOKEY|SMOKIE|SMOKIN|SMOKING|SMOKN|SMOKY|TABACCO
SNACK|SNACKBAR|SNACKING
SNAP|SNAPDRAGON|SNAPON|SNAPP|SNAPPER|SNAPPY|SNAPSHOT|SNAPPED|SNAPBACK
SNEAK|SNEAKER|SNEAKY|SNUCK|SNEAKING
SNOW|SNOWBALL|SNOWBIRD|SNOWBOARD|SNOWCONE|SNOWFLAKE|SNOWLINE|SNOWMAN|SNOWMOBILE|SNOWPLOW|SNOWPLOWING|SNOWSHOE|SNOWY
SNUFF|SNUFFY
SOAP|SOAPBOX|SOAPERY|SOAPSTONE|SOAPWORK|SOAPY
SOAR|SOARE|SOARING|SOARED
SOCCER|SCCER
SOCIAL|SOCI|SOCIA|SCIAL|SOCIALE|SOCIALITE|SOCIALLY|SOCIE|SOCIEDAD|SOCIET|SOCIETA|SOCIETE|SOCIETIE|SOCIETY|SCIETY|SOCIO|SOCTY
SOCK|SOCKET
SOFTBALL|SFTBALL|SFTBLL
SOFTWARE|SFTWR|SOFTWAR|SOFTWEAR|SOFTWORK
SOJOURN|SOJOURNER
SOLAR|SOLARA|SOLARE|SOLARI|SOLARIUM|SOLAIRE|SOL|SOLEIL|SOLORIO|SOLSTICE
SOLDER|SOLDERING
SOLID|SOLIDARITY
SOLUTION|SOLTION|SOLTN|SOLTUION|SOLU|SOLUCION|SOLUCIONE|SOLUT|SOLUTI|SOLUTIN|SOLUTIO|ESOLUTION|SOLLUTION|SLUTION|SLUTN|SLTION|SLTN|SLTON|SOLUTIONSCOM|SOLUTIONSINC|SOLUTIONSLLC|SOLUTIONZ|SOLUTN|SOLUTON|SOLVANG|SOLVAY|SOLVE|SOLVED|SOLVEIG|SOLVENT|SOLVER|SOLVING|SOULTION|SOULUTION|SOUTION
SOME|SOMEBODY|SOMEDAY|SOMEONE|SOMEPLACE|SOMETHIN|SOMETHING|SOMETIME|SOMEWHERE
SOON|SOONER
SOOTHE|SOOTHING|SOOTH
SOPHISTICATE|SOPHISTICATED|SOPHISTICATION
SORT|SORTER|SORTING|SORTED|SORTA
SOUL|SOULE|SOULFOOD|SOULFUL|SOULMATE|SOULSHINE
SOUND|SOUN|SOUNDER|SOUNDING|SOUNDSCAPE|SOUNDSIDE|SOUNDTRACK|SOUNDVIEW|SOUNDWAVE|SOUNDWORK|SOUNDZ|SOUNDED
SOUP|SOUPER
SOURCE|SOUR|SOURCED|SOURCEONE|SOURCING|SURCE|SRC
SOUTH|SOUTHEAST|SOUTHEASTERN|SOUTHEASTRN|SOUTHEND|SOUTHERN|SOUTHWEST|SOUTHWESTERN|SOUTHWST|SOUTHWSTERN|STH|STHAST|STHEAST|STHERN|STHRN|STHWEST
SOVEREIGN|SOVERIGN|SOVEREIGNTY
SPACE|SPACECOAST|SPACEPORT|SPACEWALK|SPACY|SPACEY
SPACKLE|SPACKLING|SPACKMAN
SPANISH|SPANGLISH|ESPADA|ESPANA|ESPANOL|ESPANOLA|ESPINA|ESPINAL|ESPINO|ESPINOLA|SPNISH
SPARK|SPARKLE|SPARKLER|SPARKLIN|SPARKLING|SPARKLY|SPARKY|SPARLING
SPEAK|SPEAKEASY|SPEAKER|SPEAKING|SPOKE|SPOKEN|SPEECH|SPEECHLANGUAGE
SPECIAL|SPECIA|SPCIAL|SPCIALIST|SPCIALIZED|SPCIALTY|SPCL|SPCLIST|SPCLST|SPCLTY|SPCLZED|SPC|SPCALIST|SPCALTY|SPECIALE|SPECIALI|SPECIALIST|SPECIALITE|SPECIALITIE|SPECIALITY|SPECIALIZE|SPECIALIZED|SPECIALIZING|SPECIALLY|SPECIALST|SPECIALT|SPECIALTEE|SPECIALTI|SPECIALTIE|SPECIALTIST|SPECIALTY|SPECILIZED|SPECILTY|SPECILZED|SPEC|SPECALIST|SPECH|SPECHT|SPECI|SPECIFIC|SPECIFICATION|SPECIFIED|SPECIMEN|SPECL|SPECLST|SPECLTY
SPECK|SPECKLED
SPECTACULAR|SPECT|SPECTACLE|SPECTATOR|SPECTER|SPECTOR|SPECTRAL
SPECTRUM|SPCTRUM|SPECTRA
SPEED|SPEEDEE|SPEEDIE|SPEEDO|SPEEDOMETER|SPEEDWASH|SPEEDWAY|SPEEDWELL|SPEEDY|SPED
SPELL|SPELLBOUND|SPELLED|SPELLER|SPELLING|SPELLMAN|SPELMAN
SPEND|SPENDING|SPENT|SPENDER
SPICE|SPICED|SPICER|SPICY
SPIN|SPINNER|SPINNING|SPUN
SPIRIT|ESPIRIT|ESPIRITU|ESPIRITUAL|ESPITIA|ESPRIT|SPIRITED|SPIRITIST|SPIRITO|SPIRITU|SPIRITUAL|SPIRITUALIST|SPIRITUALITY|SPIRITUALLY|SPIRT|SPIRTUAL|SPRITUAL|SPRTUAL
SPIT|SPITFIRE|SPITLER|SPITZ|SPAT|SPITTING
SPLICE|SPLICING|SPLICED|SPLICER
SPLIT|SPLITTER|SPLITTING
SPOIL|SPOILED|SPOILER|SPOILT
SPONSOR|SPONSORED|SPONSORSHIP|SPONSORING
SPOOK|SPOOKY
SPOON|SPOONER|SPOONFUL
SPORT|SPORTBIKE|SPORTCARD|SPORTFISHING|SPORTHORSE|SPORTING|SPORTMAN|SPORTMEN|SPORTSBAR|SPORTSCAR|SPORTSCARD|SPORTSMAN|SPORTSMEN|SPORTSPLEX|SPORTSWARE|SPORTSWEAR|SPORTSWORLD|SPORTWEAR|SPORTY|SPORTZ
SPOT|SPOTTED|SPOTTER|SPOTTING|SPOTLIGHT|SPOTLITE
SPOUT|SPOUTING
SPRAY|SPRAYED|SPRAYER|SPRAYFOAM|SPRAYING
SPREAD|SPREADER|SPREADING
SPRING|SPRINGER|SPRINGING|SPRINGTIME|SPRNG|SPRUNG
SPRINGFIELD|SPRNGFELD|SPRNGFIELD
SPRINKLE|SPRINK|SPRINKLER|SPRINKLING|SPRNKLR
SPRINT|SPRINTER|SPRINTING|SPRINTED
SPROUT|SPROUTING|SPROUTED
SPIDER|SPYDER|SPIDERY
SQUAD|SQUADRON
SQUARE|SQUARED
SQUEAK|SQUEAKY|SQUEEKY|SQUEAKER|SQUEAKING
SR|SENIOR|SENIORCARE
ST|SAINT|SANTE|SANTI|SANTA|SANTO|SNTA|STREET|STREE|STREETCAR|STREETZ
STABLE|STAB|STABILE|STABILITY|STABILIZATION|STABILIZER
STACK|STACKED|STACKER|STACKHOUSE|STACKING|STACKPOLE|STAK
STAFF|STAFFER|STAF|STAFFIN|STAFFING|STAFFNG|STF|STFFING|STFFNG
STAGE|STAG|STAGECOACH|STAGED|STAGER|STAGING|STG|STGE|STGING
STAIN|STAINED|STAINING|STAINLES
STAIR|STAIRCASE|STAIRLIFT|STAIRWAY|STAIRWELL
STAKE|STAKEHOLDER|STAKER|STAKED|STAKING
STALK|STALKER|STALKING|STALKED
STALL|STALLING|STALLED
STAMP|STAMPED|STAMPEDE|STAMPER|STAMPIN|STAMPING|STMP
STAR|STARLIGHT|STARLIT|STARLITE|STARMAN|STARSHINE|STARZ
STAT|STATISTIC|STATISTICAL
STATE|STATED
STATION|STATIO|STATIONARY|STATIONER|STATIONERY|STATN|STN|SUBSTATION
STE|SAINTE|SUITE
STEAD|STEADFAST|STEADY
STEAK|STEAKHOUSE|STKHUSE|TBONE
STEAM|STEAMATIC|STEAMBOAT|STEAMED|STEAMER|STEAMFITTER|STEAMING|STEAMPUNK|STEAMSHIP|STEAMWAY|STEEMER
STEEL|STEELWORK|STEELWORKER|STEELY
STEEP|STEEPLE|STEEPLECHASE
STEER|STEERE|STEERING
STENCIL|STENCILING|STENCILED
STEP|STEPBYSTEP|STEPPING|STEPPINGSTONE|STEPSTONE|STEPTOE|STEPUP|STEPPED
STERILE|STERILIZATION
STEWARD|STEWARDSHIP
STIMULATION|STIMULU|STIMULOU
STINK|STINKY|STINKER|STINKING|STANK
STITCH|STITCHE|STITCHED|STITCHER|STITCHERY|STITCHIN|STITCHING
STANDARD|STNDRD
STOCK|STOCKADE|STOCKER|STOCKING|STOCKYARD
STOKE|STOKED|STOKER|STOKING
STONE|STONEAGE|STONED|STONER|STONEY|STONY
STOP|STOPNGO|STOPPER|STOPPING|STOPPED|STOPPAGE
STORAGE|STOR|STORA|STORAG|STORALL|STORED|STORER|STORGE|STORIT|STOW|STOWAWAY
STORM|STORMER|STORMIN|STORMWATER|STORMY|STORMED|STORMING
STORY|STORYTELLER|STORYTELLING|STORYTIME|TALE|STOREY
STRAIGHT|STR8|STRAIGHTLINE|STRAIGHTWAY|STRAIT
STRANGE|STRANG|STRANGER|STRANGELY
STRAP|STRAPPING|STRAPPED
STRAT|STRATA|STRATAGEM|STRATAGIE|STRATE|STRATEG|STRATEGI|STRATEGIC|STRATEGIE|STRATEGIST|STRATEGY|STRATGIC|STRATGIE|STRG|STRGC|STRTEGIE|STRTEGY|STRTGIE|STRGE|STRATO|STRATOSPHERE|STRATUM
STREAM|STREAMER|STREAMING|STREAMLINE|STREAMLINED|STREAMED
STRETCH|STRETCHER|STRETCHNGROW
STRIKE|STRIKER|STRIKING
STRIP|STRIPE|STRIPED|STRIPER|STRIPING|STRIPLING|STRIPPER|STRIPPING|STRPING|STRPPING
STRIVE|STRIVER|STRIVING
STROKE|STROKER|STROKED|STROKING
STROLL|STRL|STRLNG|STROLLER|STROLLED|STROLLING
STRONG|STRENGTH|STRENGTHENING|STRNGTH
START|STRT|STRTER|STARTER|STARTED|STARTING
STRUCTURE|STRUCT|STRUCTRAL|STRUCTUAL|STRUCTURAL|STRCTRE|STRCTURE|STRUCTURED
STUDENT|STUDNT|STUDT|STDNT
STUDIO|STDIO|ESTUDIO|STUDIOZ|STUIDO
STUDY|STDIE|STUDI|STUDIE|STDY|STUDIED|STUDYING
STUFF|STUF|STUFFED|STUFFER|STUFFING
STUN|STUNNING|STUNNER|STUNNED
STYLE|STYL|STYLECRAFT|STYLED|STYLER|STYLEZ|STYLI|STYLIN|STYLING|STYLISH|STYLIST|STYLISTIC|STYLIZED|STYLNG|STYLO|STYLON|STYLU|STYLZ|STYRON
SUBDIVISION|SUBD|SUBDIV|SUBDV
SUBLIMATION|SUBLIME|SUBLIMINAL|SUBLIMATE
SUBSCRIBE|SUBSCRIBER|SUBSCRIPTION
SUBSIDIARY|SUBSIDIARIE|SBUSID
SUBSTANCE|SBSTNCE
SUBURB|SUBURBAN|SUBURBIA
SUCCEED|SUC|SUCC|SUCCE|SUCCES|SUCCESSFUL|SCCES|SUCCESSFULLY|SUCES|SUCCESSION|SUCCESSOR
SUDAN|SUDANESE
SUDDEN|SUDDENLY
SUIT|SUITABLE|SUITCASE|SUITED|SUITOR
SUM|SUMMARY|SUMM|SUMMATION
SUMMER|SUMMERTIME|SUMMERY
SUMMIT|SUMMITT
SUN|SUNLIGHT|SONLIGHT|SUNLIT|SUNLITE|SUNNY|SONSHINE|SUNRISE|SONRISA|SONRISE|SUNRIZE|SNRISE|SUNSET|SNSET|SUNSHINE|SNSHINE|SUNUP|SUNVIEW|TWILIGHT|TWILITE|SUNDOWN
SUPER|SUPERB|SUPERLATIVE
SUPERIOR|SPERIOR
SUPERVISE|SUPERVISED|SUPERVISION|SUPERVISOR|SUPERVISORY|SUPERINTENDENT|SUPERVISING
SUPPLEMENT|SUPPLEMENTAL
SUPPLY|SPPLY|SUPPLYINC|SUPPLI|SUPPLIE|SUPPLIER|SUPPY|SUPL|SUPLY|SUPPL
SUPPORT|SPT|SPTC|SPTG|SPRT|SPPORT|SPPRT|SUPPORTED|SUPPORTER|SUPPORTING|SUPPORTIVE|SUPPO|SUPPOR|SUPPRT
SUPREME|SUPRA|SUPREMA|SUPREMACY|SUPREMO
SURE|SUREFIRE|SURELY|SURESHOT|SURETY|SUREWAY
SURF|SURFACE|SUBSURFACE|SRF|SRFC|SURFACING|SURFBOARD|SURFC|SURFER|SURFIN|SURFING|SURFSIDE
SURGEON|SURG|SURGCL|SURGERY|SURGI|SURGICAL|SURGICARE|SURGICENTER|SURGRY|SRG|SRGCAL|SRGCL|SRGEON|SRGERY|SRGICAL|SRGON|SRGRY|SRGY
SURROGATE|SURROGACY
SURROUND|SURROUNDED|SURROUNDING
SURVEY|SURV|SURVEILLANCE|SRVEILLANCE|SRVEYING|SRVLLNCE|SRVYING|SRVYOR|SURVEYING|SURVEYOR|SURVEYED
SURVIVE|SURVIVAL|SERVIVE|SURVIVING|SURVIVOR|SURVY
SUSPEND|SUSPENDED|SUSPENDER|SUSPENSION
SUSTAIN|SUSTAINABILITY|SUSTAINABLE|SUSTAINED|SUSTAINING|SUSTAITA|SUSTANBLE|SSTNBLE|SUSTENANCE
SWAB|SWABBING|SWABY
SWAG|SWAGGER
SWALLOW|SWALLOWING|SWALLOWED|SWALLOWER
SWEDE|SWEDEN|SWEDISH
SWEEP|SWEEPER|SWEEPING|SWEEPSTAKE|SWEPT
SWEET|SWEETEN|SWEETER|SWEETEST|SWEETHEART|SWEETIE|SWEETING|SWEETLY|SWEETNES|SWEETPEA|SWEETY|SWEETZ|SWEETENER|SWEETENING
SWIM|SWIMMER|SWIMMING|SWIMWEAR|SWMMING|SWAM|SWUM
SWINDLE|SWINDLER
SWING|SWINGER|SWINGIN|SWINGING
SWITCH|SWITCHING|SWITCHED
SYMBIOTIC|SYMBIOSI
SYMBOL|SYM|SYMBOLIC|SYMBOLISM
SYMMETRY|SYMMETRIC
SYMPHONY|SYMPHONIC
SYNAPSE|SYNAPTIC
SYNC|SYNCHRO|SYNCHRONICITY|SYNCHRONIZED|SYNCHRONY|SYNCH|SYNCHRONIZE
SYNDICATE|SYNDICATED|SYNDICATION
SYNERGY|SYNERGETIC|SYNERGIE|SYNERGISTIC
SYSTEM|SYST|SYSTE|SYSTEMATIC|SYSTEMIC|SYSTEMSINC|SYSTM|SYSTME|SYSYTEM|TELESYSTEM
TABERNACLE|TABERNACULO|TABERNCLE|TBERNACLE|TBRNACLE|TBRNCLE
TABLE|TABLA|TABLER|TABLEROCK|TABLET|TABLETOP|TABLEWARE|TABULA
TACK|TACKLE|TACKY|TACKER|TAC
TACO|TACQUERIA|TAQUERIA|TAQUITO|TORTILLA|TORTILLERIA
TACONIC|TACONY
TACT|TACTIC|TACTICAL|TACTILE|TCT|TCTCAL|TCTICAL
TAEKWONDO|TAE|TAEK|TAEKWON|TKW|TKWNDO
TAHITI|TAHITIAN
TAIL|TAILER|TAILGATE|TAILGATER|TAILGATING|TAILZ
TAILOR|TAILORED|TAILORING|TAILORMADE
TAIWAN|TAIWANESE
TAKE|TAKEDOWN|TAKEN|TAKEO|TAKEOFF|TAKEOUT|TAKEOVER|TAKER|TAKIN|TAKING
TALENT|TALEN|TALENTED|TALENTO|TALLENT|TLENT
TALK|TALKER|TALKIN|TALKING|TALKED
TALL|TALLER
TAME|TAMER|TAMED|TAMING
TANDOOR|TANDOORI
TAN|TANNING|TANNED|TANNER|TANFASTIC|TANNERY|TANNIN
TANGLE|TANGLED|TANGLEWOOD
TAO|TAOIST
TAP|TAPA|TAPATIA|TAPATIO|TAPPER|TAPPING
TAPE|TAPER|TAPING|TAPED
TAPESTRY|TAPESTRIE
TARGET|TARGETED|TARGETING
TASK|TASKER|TASKFORCE
TASTE|TASTEBUD|TASTEE|TASTEEFREEZ|TASTEFUL|TASTEFULLY|TASTER|TASTIE|TASTING|TASTY
TAT|TATOO|TATTO|TATTOO|TATTOOED|TATTOOING|TATTOOZ|TATU|TTTOO
TAX|TAXATION|TAXCO|TAXE|TAXEXEMPT|TAXFREE|TAXING|TAXMAN|TAXPAYER|TAXPRO|TAXX
TAXI|TAXICAB
TAXIDERMY|TAXIDERMIST|TXDRMY
TEA|TEACUP|TEAHOUSE|TEAPOT|TEAROOM|TEEGARDEN|TEAGARDEN
TEACH|TCH|TCHER|TCHING|TEACHE|TEACHER|TEACHEY|TEACHING|TEACHOUT|TEACHR|TEAC|TCHR|TUTOR|TTORING|TUTORIAL|TUTORING
TEAK|TEAKWOOD
TEAM|TEAMMATE|TEAMSTER|TEAMWORK|TEAMED|TEAMING
TEAR|TEARDROP|TORN|TEARING|TEARED
TEASE|TEASER
TECH|TEC|TCHNCAL|TCHNCL|TCHNICAL|TCHNLGY|HITECH|HITEC|HITEK|TECHE|TECHIE|TECHINCAL|TECHLINE|TECHN|TECHNCAL|TECHNCL|TECHNE|TECHNET|TECHNI|TECHNIC|TECHNICA|TECHNICALLY|TECHNICIAN|TECHNICOLOR|TECHNIK|TECHNIQUE|TECHNLGY|TECHNLOGY|TECHNO|TECHNOL|TECHNOLGIE|TECHNOLGY|TECHNOLIGIE|TECHNOLO|TECHNOLOG|TECHNOLOGI|TECHNOLOGIC|TECHNOLOGICAL|TECHNOLOGIE|TECHNOLOGIESINC|TECHNOLOGIST|TECHNOLOGY|TECHO|TECHOLOGIE|TECHOLOGY|TECHONOLOGIE|TECHONOLOGY|TECHPRO|TECHSTAR|TECHTRONIC|TECHWORK|TECK|TECNICA|TECNICO|TECNO|TECNOLOGIA|TECNOLOGIE|TECNOLOGY|TEK|TEKK|TEKNO|TEKNOLOGIE|TECHNICAL
TEEN|TEENA|TEENAGE|TEENAGER|TWEEN
TEL|TELA|TELACU|TELCO|TELCOM|TELCOMM|TELE|TELECARD|TELECARE|TELECELL|TELECO|TELECOM|TELECOMM|TELECOMMUNICATION|TELEDATA|TELEDYNE|TELEGRAM|TELEGRAPH|TELEMEDIA|TELEMETRY|TELEMUNDO|TELENET|TELEPH|TELEPHON|TELEPHONE|TELEPHONY|TELEPORT|TELEPRODUCTION|TELESI|TELESTAR|TELETECH|TELEVISION|TELSTAR|TLCOM|TLE|TLECOM|TMOBILE|TVVCR
TELL|TELLER|TELLING
TEMP|TEMPCO|TEMPER|TEMPERATURE|TEMPERED|TEMPORARY|TEMPORARIE|TMP|TMPRY
TEMPLE|TEMPLEMAN|TEMPLER|TMPL|TMPLE
TEMPT|TEMPTED|TEMPTATION|TEMPTING
TENACIOU|TENACITY
TEND|TENDER|TENDERCARE|TENDERFOOT|TENDING
TEQUILA|TEQUILLA
TERM|TERMINAL|TERMINI|TERMINATOR|TERMINIX|TRM|TRML
TERR|TERRA|TERRACE
TERROR|TERRORISM|TERRORIST
TEST|TESTED|TESTER|TESTING|TST|TSTG
TESTAMENT|TESTAMENTARY|TESTIMONY
TEXT|TEXTBOOK|TEXTUAL|TEXTING|TEXTED
TEXTURE|TEXTURED|TEXTURING
THAI|THAILAND
THANK|THANKFUL|THANKSGIVING|THANKED|THANKING
THEATER|THEAT|THATER|THATRE|THEATR|THEATRE|THEATRIC|THEATRICAL|THESPIAN|THTER|THTR|THTRE
THEME|THEMED|THEMATIC
THEOLOGY|THEOLOGICAL|THLGCAL
THEORY|THEOREM|THEORIE|THEORETICAL
THERAPY|THAIRAPY|THERAPEUTC|THERACARE|THERAP|THERAPEUTIC|THERAPHY|THERAPI|THERAPIE|THERAPIST|THERAPTIC|THERAPUETIC|THERAPUTIC|THERPY|THRAPEUTIC|THRAPIST|THRAPY|THRP|THRPEUTIC|THRPIE|THRPIST|THRPST|THRPTC|THRPTIC|THRPUTIC|THRPY|TREATMENT|TREATM|TREATME|TREATMEN|THEARPY|TRTMNT|TREATMNT|TRMT
THERMAL|THERMAX|THERMO|THERMOGRAPHIC|THERMOGRAPHY|THERMOPLASTIC
THICK|THICKET
THEFT|THIEVE|THIEF
THING|THINGZ
THINK|THINKER|THINKING|THINKTANK
THIN|THINNING|THINNER
THIRST|THIRSTY
THOROUGH|THORO|THOROBRED|THOROUGHBRED|THOROUGHLY
THOUGHT|THOUGHTFUL
THRASH|THRASHER|THRASHING
THREAD|THREADED|THREADING|THREADWORK|THREADZ
THREAT|THREATT|THREATEN|THREATENING|THREATENED
THRIFT|THIRFT|THRFT|THRIFTWAY|THRIFTY
THRIVE|THRIVENT|THRIVING
THROUGH|THRGH|THRU|THROUGHBRED|THRUGH|THRUWAY
THROW|THROWBACK|THROWER|THROWING
THUMB|THUM|THUMBPRINT
THUMP|THUMPER
THUNDER|THUNDERBIRD|TBIRD|THUNDERBOLT|THUNDERHEAD|THUNDERING|THUNDERSTRUCK|THNDER
TICK|TICHY|TICKER|TICKET|TICKETING|TICKETER|TICKETED|TICKING|TICKED
TICKLE|TICKLED|TICKLING|TICKLER
TIDE|TIDELAND|TIDEWATER|TIDEWTER|TIDING|TIDAL
TIE|TIED|TYING
TIEN|TIENDA|TIENDITA
TILE|TILEWORK|TILING|TILED
TILL|TILLAGE|TILLING|TILLER
TILT|TILTED|TILTING
TIME|TIMELES|TIMELINE|TIMELY|TIMEOUT|TIMEPIECE|TIMER|TIMESAVER|TIMESHARE|TIMEWISE|TIMING|TIMED
TINGLE|TINGLER|TINGLEY|TINGLING
TINT|TINTER|TINTING|TNTING|TINTED
TIP|TIPPY|TIPSY|TIPPING|TIPPER|TIPPED
TIRE|TIRED|RETREAD|RETREADING|TYRE
TITAN|TITANIC|TITANIUM|TITIAN
TITLE|TITLEHOLDER|TITLING
TOAST|TOASTED|TOASTER|TOASTMASTER|TOASTY|TOASTING
TOBACCO|TOB|TOBA|TOBACCONIST
TOGETHER|TGETHER
TOMATO|TOMATOE
TOMORROW|TOMMORROW|TMRROW
TONE|TONER|TONED|TONING
TOOL|TOOLBOX|TOOLING|TOOLWORK|TOOLED|TOOLIE
TOPIC|TOPICAL
TORCH|TORCHIA|TORCHLIGHT
TOTAL|TOTALLY
TOUCH|TOUCHED|TOUCHING|TOUCHLES|TOUCHPOINT|TOUCHSTONE|TOUCHTONE|TOUCHTON|TOUCHUP|TOUCHET|TOUCHETTE
TOUR|TOURE|TOURETTE|TOURING|TOURISM|TOURIST|TURING|TURIN|TURI|TURISMO
TOURNAMENT|TOURNEY|TURNEY
TOWER|TOWERING
TOW|TOWIN|TOWI|TOWING
TOWN|TOWNCENTER|TOWNE|TOWNECRAFT|TOWNEHOME|TOWNER|TOWNHME|TOWNHOME|TOWNHOUSE|TOWNLEY|TOWNLINE|TOWNSEND|TOWNSHEND|TOWNSHIP|TOWNSHP|TOWNSITE|TOWNSQUARE|TWNHM|TWNHME|TWNHOME|TWNHOUSE|TWNHSE|TWNHUSE|TWNE|TWNSHIP|TWNSHP
TOXIC|TOXICOLOGY
TOY|TOYBOX|TOYLAND|TOYZ
TN|TENN|TENNESSEE
TRACE|TRACER|TRACING|TRACK|TRACKER|TRACKING|TRACKSIDE|TRAK|TRACED|TRAX|TRAXX
TRACT|TRACTOR|TRACTION|TRCTR
TRADE|TRAD|TRADELINK|TRADEMARK|TRADENAME|TRADER|TRADESHOW|TRADESMAN|TRADESMEN|TRADEWIND|TRADEX|TRADI|TRADIN|TRADING|TRDE|TRDG|TRDNG
TRADITION|TRADITIONAL|TRADITNAL|TRDTNAL
TRAFFIC|TRAFFICKING|TRFFIC
TRAIL|TRAI|TRAILBLAZER|TRAILER|TRAILHEAD|TRAILOR|TRAILRIDER|TRAILSIDE|TRAILWAY|TRAILWOOD|TRLR
TRAIN|TRAINED|TRAINER|TRAING|TRAINI|TRAININ|TRAINING|TRAINNG|TRAINOR|TRANG|TRANING|TRINING|TRN|TRNER|TRNG|TRNING|TRNNG
TRAM|TRAMWAY
TRANQUIL|TRANQUILITY|TRANQUILLITY
TRANSACT|TRANSACTION|TRANSACTIONAL|TRNSCTION
TRANSCEND|TRANSCENDENCE|TRANSCENDENT|TRANSCENDENTAL|TRANSCENDING
TRANSCRIPT|TRANSCRIBER|TRANSCRIBING|TRANSCRIPTION|TRNSCRIPTION|TRNSCRPTION
TRANSFER|TRANSF|TRANSFERRAL|TRANSFERRING|TRANSFERRED|TRANSFERAL|TRANSFERING|TRANSFERED
TRANSFORM|TRANSFIGURATION|TRANSFORMATION|TRANSFORMATIONAL|TRANSFORMATIVE|TRANSFORMED|TRANSFORMER|TRANSFORMING|TRANSFRMTION|TRNSF|TRNSFORMATION|TRNSFRMATION|TRNSFRMTION
TRANSIT|TRANSITION|TRANSITIONAL|TRANSITIONING|TRNSITION|TRNSITIONAL|TRNST|TRNSTION|TRNSTNAL
TRANSLATE|TRANSLATING|TRANSLATION|TRANSLATIONAL|TRANSLATOR|TRNSLATION|TRNSLTION
TRANSMIT|TRANSMISSION|TRANMISSION|TRANSMITTER|TRANSMI|TRNSM|TRNSMISSION|TRNSMSSION|TRNSMSSON
TRANSPARENT|TRANSPARENCY
TRANSPLANT|TRANSPLANTING
TRANSPORT|TRANPORT|TRANSPO|TRANSPOR|TRANSPORATATION|TRANPORTATION|TRANSPORATION|TRANSPORTA|TRANSPORTAION|TRANSPORTAT|TRANSPORTATI|TRANSPORTATIO|TRANSPORTATION|TRANSPORTATIONLLC|TRANSPORTE|TRANSPORTER|TRANSPORTION|TRANSPORTLLC|TRANSPOTATION|TRANSPRO|TRANSPRTATION|TRANSPRTTION|TRASPORT|TRASPORTATION|TRNSP|TRNSPORTATION|TRNSPRT|TRNSPRTATION|TRNSPRTN|TRNSPRTTION|TRANSPORTING|TRNSPT
TRAP|TRAPPE|TRAPPER|TRAPPING|TRAPPED
TRASH|TRASHOUT|TRASHY|TRASHED
TRAUMA|TRAUMATIC|TRUMA
TRAVEL|TRAV|TRAVE|TRAVELCOM|TRAVELED|TRAVELER|TRAVELHOST|TRAVELIN|TRAVELING|TRAVELLER|TRAVELLING|TRAVELODGE|TRAVL|TRV|TRVEL|TRVL
TREASURE|TREASUR|TRASURE|TREASURED|TREASURER|TREASURY|TRESURE|TRSRE|TRSURE
TREAT|TREATED|TREATER|TREATING|TREATY|TREATZ|TREET
TREE|TREEHOUSE|TREELINE|TREETOP|TREEWORK
TREK|TREKKER|TREKKIE
TRENCH|TRENCHER|TRENCHING|TRENCHLES|TRENCHE
TREND|TRENDI|TRENDING|TRENDSETTER|TRENDY|TRENDZ|TRENZ
TRIANGLE|TRIANGULAR|TRNGLE
TRIBE|TRIBAL
TRIBUTE|TRIBUTARY
TRY|TRIED|TRIER|TRYING
TRIM|TRIMED|TRIMLINE|TRIMM|TRIMMER|TRIMMING|TRIMWORK|TRIMMED
TRINITY|TRINITI|TRNTY
TRIPOD|TRIPODI
TRIP|TRIPP|TRIPPE|TRIPPER|TRIPPIN|TRIPPED
TRIUMPH|TRIUMPHANT|TRIUMPHAL
TROOP|TROOPER|TROUP|TROUPE
TROPHY|TROPHIE
TROPIC|TROPI|TROPICAL|TROPICALE|TROPICANA|TROPICO|TROPIX|TRPCL
TROUBLE|TROUBLED|TROUBLESHOOTER|TROUBLING|TROUBLESHOOTING
TRUCK|TRCK|TRCKG|TRCKING|TRUK|TRUKING|TRCKNG|TRUCKER|TRUCKI|TRUCKIN|TRUCKING|TRUCKINGINC|TRUCKINGLLC|TRUCKLINE|TRUCKLOAD|TRUCKN|TRUCKNG|TRUCKSTOP|TRUC|TRK|TRKG|TRKING|TRKNG
TRUE|TRULY|TRUTH
TRUST|TRST|TRSTEE|TRUSTE|TRUSTED|TRUSTEE|TRUSTING|TRUSTWORTHY|TRUSTY
TSQUARE|TSQUARED
TUBE|TUBING|TUBULAR
TUITION|TUIT
TUMBLE|TUMBLER|TUMBLEWEED|TUMBLIN|TUMBLING|TUMBLED
TUNE|TUNED|TUNER|TUNEUP|TUNING
TUNNEL|TUNNELING|TUNNELL|TUNNELER|TUNNELED
TUPPER|TUPPERWARE
TURK|TURKEY|TURKISH
TURN|TURNAROUND|TURNED|TURNER|TURNING|TURNINGPOINT|TURNKEY|TURNOVER|TURNTABLE
TURNIP|TURNIPSEED
TURNPIKE|TPKE
TUX|TUXEDO
TWEED|TWEEDIE|TWEEDY
TWEET|TWEETY|TWEETER|TWEETED|TWEETING|TWITTER
TWINE|TWINING|TWNG
TWINKLE|TWINKLING
TWIN|TWINZ
TWIRL|TWIRLER|TWIRLING
TWIST|TWIS|TWISTED|TWISTER|TWISTING
TWITCH|TWITTY|TWIZTED|TWITCHY
TX|TEXAS|TEX
TYPE|TYPESETTER|TYPESETTING|TYPEWRITER|TYPING|TYPOGRAPHER|TYPOGRAPHIC|TYPOGRAPHY|TYPSG|TYPTR|TYPED
UBIQUITOU|UBIQUITY
UGLY|UGLIER
UKRAINE|UKRAINIAN|UKRANIAN
ULTIMA|ULTIMATE|ULTIMO|ULTMATE|ULTRA|ULTRALIGHT|ULTRAMAR|ULTRASONIC|ULTRASOUND|ULTRATECH
UNBEATABLE|UNBELIEVABLE|UNBOUND|UNBREAKABLE|UNBRIDLED|UNBROKEN|UNCHAINED
UNDER|UNDERCAR|UNDERCOVER|UNDERDOG|UNDERGARMENT|UNDERGROUND|UNDERGRUND|UNDERHILL|UNDERLINED|UNDERNEATH|UNDERSEA|UNDERWATER|UNDERWEAR|UNDERWOOD|UNDERWORLD|UNDGRD
UNDERSTAND|UNDERSTANDING
UNDERTAKE|UNDERTAKING|UNDERTAKER
UNDERWRITE|UNDERWRITER|UNDERWRITING|UNDRWRTER|UNDWRT|UNDERWRITTEN
UNFORGETTABLE|UNFORGETABLE|UNFORGOTTEN
UNIFY|UNIFIED|UNFIED|UNIDA|UNIDAD|UNIDO|UNIFICATION|UNIFORM|UNIFORMED|UNIFOUR|UNIO|UNION|UNIONDALE|UNIONTOWN|UNIONVILLE|UNITA|UNITARIAN|UNITD|UNITE|UNITED|UNITEDSTATE|UNITING|UNITY|UNTD|UNTED|UNTIED|UTD
UNIQUE|UNIQ|UNIQUELY|UNQUE
UNIVERSE|UNIV|UNIVE|UNIVER|UNIVERAL|UNIVERISTY|UNIVERSAL|UNIVERSALIST|UNIVERSIDAD|UNIVERSITIE|UNIVERSITY|UNIVERSO|UNIVERSTY|UNIVEST|UNIVISION|UNIVRSL|UNVERSAL|UNVRSAL|UNVRSTY
UNKNOWN|UNK
UNLEASH|UNLEASHED
UNLIMITED|UMLIMITED|UNLI|UNLIM|UNLIMI|UNLIMIT|UNLIMITE|UNLIMTED|UNLMITED|UNLMTD|UNLMTED|UNLTD
UNLOCK|UNLOCKED|UNLOCKING
UPCYCLE|UPCYCLED|UPCYCLING
UPHOLSTERY|UPHLSTRY|UPHOL|UPHOLESTRY|UPHOLST|UPHOLSTE|UPHOLSTER|UPHOLSTERED|UPHOLSTERER|UPHOLSTERING|UPHOLSTREY|UPHOLSTRY|UPHOSTERY|UPOLSTERY
UP|UPLIFT|UPLIFTING|UPLIFTED|UPLIFTER|UPPER|UPPERCASE|UPPERCUT|UPSTAIR|UPWARD|UPRISE|UPRISING
URBAN|URBANA|URBANDALE|URBANE|URBANEK|URBANO|URBANSKI|URBANWEAR|URBINA
URGE|URGENT|URGNT|URGENTLY
UROLOGICAL|UROGYNECOLOGY|UROLOGIC|UROLOGIST|UROLOGY|UTI
URSA|URSO|URSU|URSULA|URSULINE|URSZULA
US|US1|USA|USAA|USACOM|USADA|USAF|USAINC|USDA|USINC|USLLC
USABLE|USABILITY
USB|USBC
USE|USED|USEDLC|USEFUL|USELTON|USER|USING|PREOWNED
UT|UTA|UTAH
UTTER|UTTERLY|UDDER|UDDERLY
UTILITY|UTIL|UTILI|UTILITE|UTILITIE|UTILIZATION|UTLITIE|UTLITY|UTLTIE
UTOPIA|UTOPIAN
VA|VIRGINA|VIRGINI|VIRGINIA|VIRGINIAN|VRGINIA|VRGNIA
VACANT|VACATION|VACATIONLAND|VCATION|VACTION|VCTION
VACCINATION|VACCINE|VAX
VACUUM|VACCUM
VAIN|VANITY|VANITIE
VALENCE|VALENT|VALLANCE|VLNCE
VALENTA|VALENTE|VALENTI|VALENTIN|VALENTINA|VALENTINE|VALENTINI|VALENTINO
VALERA|VALERI|VALERIA|VALERIAN|VALERIANO|VALERIO|VALERIU|VALERIY
VALERY|VALARY|VALARIE|VALERIE|VALLERY|VALORIE
VALET|VALLET
VALIANT|VALIENT|VELIENTE|VALLIANT
VALID|VALIDATION|VALIDU|VALIENTE|VALIDITY|VALIDATE
VALLEY|VALEY|VALLE|VALLEE|VALLEYBROOK|VALLEYVIEW|VALLEYWIDE|VALLI|VALLIE|VALLY|VLLEY|VLLY|VLY
VALLIER|VALLIERE
VALOR|VALORE|VALOREM|VALOROU
VALPARAISO|VALPO
VALUE|VALU|VALUABLE|VALUATION|VALUED|VLUE
VALVE|VALVED
VANDENBERG|VANDENBURG
VANISH|VANISHING|VANISHED
VAPE|VAPER|VAPING|VAPOR
VAQUERA|VAQUERO
VASCULAR|VSCLAR|VSCULAR
VARNISH|VARNISHED
VARY|VARIABLE|VARIAN|VARIANT|VARIATION|VARIED|VARIEDADE|VARIETIE|VARIETY|VARITY
VAUGHAN|VAUGHN
VAULT|VALT
VEAL|VEALE
VECCHIA|VECCHIO|VECCHIONE
VECTOR|VECTRA
VEG|VEGETABLE|VEGA|VEGAN|VEGE|VEGETARIAN|VEGETATION|VEGGIE
VEIL|VEILED
VELOCITY|VELO|VELOCE|VELOSO
VENDETTA|VENDETTI
VEND|VENDING|VENDITTI|VENDOR|VENDER
VENEZUELA|VENEZUELAN
VENICE|VENETA|VENETIA|VENETIAN|VENETO|VENEZIA
VENT|VENTA|VENTER|VENTI|VENTILATING|VENTILATION|VENTO|VENTR|VENTRE
VENTURE|VENTRUE|VENTUR|VENTURA|VENTURER|VENTURESLLC|VENTURI|VNTR|VNTRE|VNTURE
VENUE|VENU
VENUTI|VENUTO
VERANDA|VERANDAH
VERB|VERBA|VERBAL|VERBATIM|VERBO
VERDA|VERDAD|VERDANT|VERDE|VERDI|VERIDIAN|VERMILION|VERMILLION|VERMILYEA|VERT|VERTE|VIRIDI|VIRIDIAN
VERIFY|VERIFICATION|VERIFIED|VERITA|VERITE|VERITY
VERONICA|VERONIKA|VERONIQUE
VERRET|VERRETT
VERSATILE|VERSATILITY
VERSE|VERSED
VERTICAL|VERTI|VERTIGO
VESSEL|VESSELL
VEST|VESTA|VESTAL|VESTAR|VESTAVIA|VESTED|VESTER|VESTMENT|VESTOR|VESTRY|VESTRYMEN
VET|VETERAN|VETERINARIAN|VETERINARY|VETERN|VETERNARY|VETRAN|VETRN|VTERAN|VTERINARY|VTRAN|VTRINARY|VTRN|VTRNARY|VTRNRY
VIA|VIABLE|VIACOM|VIADUCT
VIAGGIO|VIAJE
VIBE|VIB|VIBEZ|VIBRA|VIBRANCE|VIBRANT|VIBRATION
VIC|VICK|VICKER|VICKERY|VICKEY|VICKI|VICKIE|VICKNAIR|VICKREY|VICKSBURG|VICKY|VIK
VICTIM|VCTM
VICTOR|VICTORI|VICTORIA|VICTORIAN|VICTORIANA|VICTORIANO|VICTORIE|VICTORINO|VICTORIO|VICTORIOU|VICTORVILLE|VICTORY|VCTOR|VCTORY|VCTRIA|VIKTOR|VIKTORIA|VIKTORIYA|VITORIA|VITTORIA|VITTORIO
VIDEO|VIDE|VIDEOGRAPHY|VIDO
VIEJA|VIEJO
VIELE|VIEN|VIENE|VIENNA|VIENTO
VIETNAM|VIETNAMESE|VIETNMESE
VIEW|VIEWER|VIEWING|VIEWMONT|VIEWPOINT
VIGIL|VIGILANCE|VIGILANT|VIGILANTE
VILLA|VILA|VILL
VILLAGE|VILLAG|VILLAGER|VILLAGGIO|VILLAGIO|VLLG|VLLGE
VINCE|VINCENNE|VINCENT|VINCENTE|VINCENTI|VINCENZA|VINCENZO|VINCI|VINCIGUERRA|VINCO|VINNIE|VINNY|VINZANT|VNCENT|VICENT|VICENTE
VINE|VINEGAR|VINELAND|VINER|VINEWOOD|VINEY|VINEYARD|VINH|VINI|VINING|VINO|VINT|VINTAGE|VINTNER|VINYARD|VINYRD|VNTAGE|VNYRD
VINYL|VNYL
VIOLENT|VIOLANTE|VIOLATION|VIOLENCE
VIOLET|VIOLETA|ULTRAVIOLET
VIOLIN|VIOLETTA|VIOLETTE|VIOLA
VIRGIN|VIRG|VIRGA|VIRGEN|VIRGI|VIRGIE|VIRGIL|VIRGILIO|VIRGO
VIRTUE|VIRTU|VIRTUA|VIRTUAL|VIRTUALLY|VERTU|VIRTUOSO|VIRTUOU|VRTUAL
VIRU|VIRAL
VISCONTI|VISCOUNT
VISIBLE|VISIBILITY|VISIO|VISION|VISIONARIE|VISIONARY|VISIONQUEST|VISIONWORK|VISIONZ|VISON|VISOR|VISUAL|VISUALIZATION|VISUALIZE|VISUALLY|VIZION|VIZ|VSION
VISIT|VISITATION|VISITING|VISITOR|VISTOR|VITOR
VITA|VIT|VITAE|VITAL|VITALE|VITALI|VITALII|VITALITY|VITALIY|VITALY
VITELLI|VITELLO|VITESSE|VITI|VITIELLO|VITO
VIVA|VIVACE|VIVACIOU|VIVALDI|VIVAN|VIVANCO|VIVANT|VIVAR|VIVE|VIVEIRO|VIVO|VIVRE|VIVIR
VIVIAN|VIVI|VIVIANA|VIVIANE|VIVIANO|VIVIEN|VIVIENNE
VIVID|VIVIDLY
VLAD|VLADIMIR|VLADISLAV
VOCAL|VOCE|VOICE|VOICEMAIL|VOICEOVER
VOCATION|VCTIONAL|VCTNAL|VOCATIONAL
VOLATILE|VOLANT|VOLANTE|VOLARE|VOLATILITY|VOLENTE
VOLCANO|VOLCAN|VOLCANIC
VOLKSWAGON|VOLKSWAGEN
VOLLEY|VOLLEYBALL|VLLEYBALL|VLLYBALL
VOLLMAR|VOLLMER
VOLT|VOLTA|VOLTAGE|VOLTZ
VOLUNTARY|VOLUNTEER|VLNTEER|VLNTER|VLNTR|VOLUNTER|VOLUNTR
VOTE|VOTER|VOTING|VOTED
VOWEL|VOWELL
VOYAGE|VOYAGER|VOYAGEUR
VT|VERMONT
VULCAN|VULCANIZING
WA|WASHINGTON|WASHINGT|WASHINGTN|WASHINGTO|WASHINGTONIAN|WASHINGTONVILLE
WACK|WACKER|WACKY
WAG|WAGGER|WAGGIN|WAGGING|WAGGLE|WAGGY
WAGON|WAGONER|WAGGENER|WAGGONER
WAGE|WAGER
WAIT|WAITER|WAITING|WAITED
WAKE|WAKEUP|WAKING|WOKE|WOKEN|AWOKEN|AWAKEN|AWAKE
WALK|WALKABOUT|WALKING|WALKUP|WALKWAY|WLK|WLKER|WLKING|WALKER|WALKED
WALL|WALLBOARD|WALLCOVER|WALLCOVERING|WALLED|WALLING|WALLPAPER|WALLPAPERING|WALLWORK|WALLSTREET|WLLCOVERING|WLPR
WANDER|WANDERER|WANDERING|WANDERLUST
WANT|WANTED|WANTZ|WANTING
WARD|WARDEN|WARDROBE
WARE|WAREH|WAREHO|WAREHOU|WAREHOUSE|WAREHOUSING|WHAREHOUSE|WEARHOUSE|WHEREHOUSE|WHSE|WHSNG|WRH|WRHSE|WAREWOLF|WAREWOLVES
WAR|WARBIRD|WARFARE|WARHAWK|WARHORSE|WARRING|WARRIOR|WRRIOR
WARM|WARMER|WARMING|WARMTH|WARMED
WARN|WARNING|WARNED
WARRANT|WARR|WARRANTIE|WARRANTY
WASH|WASHBOARD|WASHED|WASHER|WASHETERIA|WASHI|WASHIN|WASHING|WASHOUT|WSH|WSHG|WSHNG
WASTE|WASTED|WASTEWATER|WSTE
WATCH|WATCHDOG|WATCHE|WATCHER|WATCHFUL|WATCHING|WATCHMAKER|WATCHMAN|WATCHMEN|WATCHTOWER|WTCH
WATER|WATR|WTER|WTR|WATERSHED|WTRSHED|WATERPROOF|WATERPROOFING|WTERPROOFING|WTRPRFING|WTRPROFING|WTRPROOFING
WAVE|WAV|WAVER|WAVING|WAVY
WAX|WAXER|WAXING|WAXY
WAY|WAYZ
WEALTH|WEALTHCARE|WEALTHY|WLTH
WEAPON|WEAPONRY|GUNSHOP|GUNSLINGER|GUNSMITH|GUNSMITHING|GUNSMOKE|FIREARM|GUNBARREL|FLINTLOCK|FREARM|GUNSTOCK|GUNWORK|GUNZ|HANDGUN|RAPIER|RIFLE|PISTOL
WEAR|WEARABLE|WEARING
WEATHER|WEATHERIZATION|WEATHERMAN|WEATHERPROOFING|WEATHERPROOF|WEATHERSBY|WEATHERPROOFED|WEATHERSTRIP|WEATHERVANE|WTHER|WHETHER|WETHER
WEAVE|WEAVER|WEAVING|WOVEN|WOVE
WEB|WEBBER|WEBBING|WEBDESIGN|WEBMASTER|WEBNET|WEBPAGE|WEBSITE|WEBSTER|WEBTECH|WEBWORK
WED|WDDING|WDDNG|WEDDING|WEDDNG
WEEK|WEEKDAY|WEEKEND|WEEKENDER|WEEKLY|WEEKNIGHT
WEIGH|WEIGHING|WEIGHT|WEIGHTLIFTING|WEIGHTLOS|WGH|WGHT
WELCOME|WELCOMING
WELD|WELDED|WELDER|WELDING|WLDG
WELL|WELLBEING|WELFARE|WELLCARE|WELLDONE|WELLING|WELNES|WLF|WLFARE|WLLNES|WLLNS
WEST|WESTERN|WESTRN|WESTWARD|WSTN|WSTRN
WET|WETLAND|WETTER|WHET|WHETSTONE
WHALE|WHALER|WHALING
WHARF|WARF
WHAT|WHATEVER|WHATNOT
WHEEL|WHEELCHAIR|WHEELER|WHEELES|WHEELHOUSE|WHEELIE|WHEELIN|WHEELING|WHEELOCK|WHEELWRIGHT|WHEELZ
WHIM|WHIMSEY|WHIMSICAL|WHIMSIE|WHIMSY
WHIP|WHIPLASH|WHIPP|WHIPPED
WHIRL|WHIRLY|WHIRLEY|WHIRLPOOL|WHIRLWIND|WHIRLING
WHISK|WISK|WHISKER|WHISKEY|WHISKY
WHISPER|WHISPERER|WHISPERING|WHISPERWOOD|WHISPRING
WHISTLE|WHISTLER|WHISTLESTOP|WHISTLING
WHITE|WHITED|WHITEN|WHITENER|WHITENING|WHTE|WHYTE
WHOLE|WHOLENES|WHOLESOME
WHOLESALE|WHLSE|WHOLESA|WHOLESAL|WHOLESALER|WHOLESALING|WHOLESELLER|WHOLSALE|WHSLE
WI|WISCONSIN|WISCO|WISCON|WSCNSIN|WSCONSIN|WISC
WIDE|WIDER|WIDESPREAD|WIDEN|WIDENER|WIDENING
WIDOW|WIDOWED
WIGGLE|WIGGLY|WIGLEY
WILD|WILDLIFE|WILDERNESS|WLDLIFE|WLDRNES|WILDCAT|WILDCATTER
WINCHESTER|WINCHSTER
WIND|WINDING|WINDMILL|WINDUP|WINDY|WNDY
WINDOW|WINDO|WNDOW|WNDW
WINE|WINERIE|WINERY|WHINERY|WHINE|WHINER|WHINING|WINING|WINED|WHINED|WINER
WING|WINGED|WINGER|WINGMAN|WINGNUT|WINGSPAN|WINGSTOP|WINGZ
WINK|WINKER|WINKING|WINKY
WIPE|WIPER|WIPING
WIRE|WIRED|WIRELE|WIRELES|WIRELS|WIRG|WIRING|WIRLES|WRELES|WRLES
WISE|WISDOM|WISEGUY|WISELY|WISER|WIZE|WIZENED|WIZEN
WISH|WISHBONE|WISHE|WISHFUL|WISHING|WISHER|WISHED
WIT|WITTY|WITZ
WITCH|WITCHE|WITCHER|WITEK
WIZ|WHIZ|WIZARD|WIZARDRY|WIZZ|WIZZARD
WILLOW|WLLOW
WINTER|WNTER|WINTERY
WOMAN|WOMEN|WMEN|WOMANCARE|WOMB|WOMN
WONDER|WONDERFUL|WONDERFULLY|WONDERLAND|WONDERLY|WONDEROU|WONDROU
WOOD|WDWKG|WDWRK|WOODCARVER|WOODCARVING|WOODCRAFT|WOODCRAFTER|WOODCRAFTING|WOODED|WOODEN|WOODIN|WOODING|WOODMAN|WOODMEN|WOODMASTER|WOODN|WOODSMAN|WOODSMITH|WOODTURNER|WOODTURNING|WOODWOR|WOODWORK|WOODWORKER|WOODWORKIN|WOODWORKING|WOODWORX|WOODWRIGHT|WOODY|TIMBER|TMB|TMBER|WOODS|WOODFIRE|WOODFIRED|WOODLAND|WOODLND|WOODSHED|WOODSHOP|WOODYARD
WOOL|WOOLEN|WOOLERY|WOOLEY|WOOLLEY|WOOLLY|WOOLMAN|WOOLY|WOOLIE|WOOLIER
WORD|WORDING|WORDPROCESSING|WORDSMITH|WORDSWORTH
WORK|WK|WKG|WKM|WKR|WORKBENCH|WORKER|WORKFLOW|WORKFORCE|WORKGROUP|WORKHORSE|WORKIN|WORKING|WORKINGMAN|WORKINGMEN|WORKLIFE|WORKMAN|WORKMEN|WORKOUT|WORKOVER|WORKPLACE|WORKROOM|WORKSHOP|WKSHP|WORKSITE|WORKSPACE|WORKSTATION|WORKWEAR|WORKX|WORKZ|WORX|WRK|WRKFORCE|WRKFRCE|WRKR|WRX
WORLD|WORLDCLAS|WORLDCOM|WORLDLINK|WORLDLY|WORLDNET|WORLDVIEW|WORLDWIDE|WORLWIDE|WRLD|WRLDWDE|WRLDWIDE
WORM|WORMER|EARTHWORM|WORMY
WORSE|WORST|WORSTED|WORSTER
WORSHIP|WORSHIPFUL|WORSHIPPER|WORSHP|WRSHP|WRSHIP
WORTH|WORTHEY|WORTHWHILE|WORTHY|WRTH
WOUND|WOUNDED
WRANGLE|WRANGLER|WRANGELL
WRAP|WRAPPED|WRAPPER|WRAPPING
WRECK|WRCKR|WRECKER|WRECKING|RECK|RECKER|RECKLES|RECKLESS
WRESTLE|WRESTLER|WRESTLING|WRSTLING
WRITE|WRIGHT|WRGHT|WRIT|WRITER|WRITING|WRITTEN|WRTER|WRTING
WITNESS|WTN|WTNES|WTNSSE
WY|WYOMING|WYMING|WYOMISSING
YACHT|YACHTING
YAHOO|YAHOOCOM
YARD|YARDAGE|YARDCARE|YARDSCAPE|YARDWORK
YEAR|YEARBOOK|YEARLING|YEARLY
YIELD|YIELDING
YOGURT|YGURT|YOGART|YOGHURT
YORK|YORKE|YORKER|YORKIE|YRK
YOUR|YOURE|YOUREE|YOURSELF|YOUVE|YRSELF
YOUTH|YOUTHFUL
YUMMY|YUMI|YUMMI|YUMMIE
YWCA|YMCA
ZAP|ZAPP|ZAPPER
ZEALAND|ZEELAND
ZEN|XEN
ZIP|ZIPLINE|ZIPP|ZIPPER|ZIPPERER|ZIPPY
ZONE|ZONING
ZOO|ZOOLOGICAL|ZOOLOGY
